Team,Wins,Losses,Home_Wins,Home_Losses,Away_Wins,Away_Losses,ATS_WINS,ATS_Losses,ATS_Ties,ATS_Home_Wins,ATS_Home_Losses,ATS_Home_Ties,ATS_Away_Wins,ATS_Away_Losses,ATS_Away_Ties,OU_Wins,OU_Losses,OU_Ties,OU_Home_Wins,OU_Home_Losses,OU_Home_Ties,OU_Away_Wins,OU_Away_Losses,OU_Away_Ties
Robert Morris,18,8,12,2,6,6,19,6,0,10,3,0,9,3,0,16,9,0,6,7,0,10,2,0
Oregon St,17,8,14,2,1,5,18,7,0,14,2,0,4,5,0,16,9,0,9,7,0,7,2,0
Hou Christian,11,13,7,5,4,8,17,5,0,8,2,0,9,3,0,12,10,0,6,4,0,6,6,0
San Jose St,12,13,6,5,2,7,17,5,1,9,3,0,8,2,1,14,9,0,7,5,0,7,4,0
UCSD,20,4,9,2,8,2,17,5,0,8,3,0,9,2,0,11,10,1,6,5,0,5,5,1
Illinois St,15,10,10,3,4,5,17,7,0,8,5,0,9,2,0,15,9,0,9,4,0,6,5,0
Omaha,16,10,9,2,6,7,17,7,0,6,5,0,11,2,0,13,11,0,6,5,0,7,6,0
Alcorn State,6,17,4,2,2,15,16,5,1,5,1,0,11,4,1,9,13,0,1,5,0,8,8,0
Central Conn,17,6,7,2,10,3,16,5,0,5,2,0,11,3,0,8,13,0,3,4,0,5,9,0
Florida,20,3,11,1,4,2,16,7,0,10,4,0,6,3,0,9,14,0,5,9,0,4,5,0
IPFW,18,8,11,1,6,6,16,8,0,7,5,0,9,3,0,15,9,0,8,4,0,7,5,0
Drexel,13,12,5,6,6,5,16,8,0,7,4,0,9,4,0,10,13,1,6,5,0,4,8,1
Siena,11,13,7,3,3,8,16,8,0,8,4,0,8,4,0,15,9,0,9,3,0,6,6,0
VMI,12,13,7,4,4,8,15,5,1,6,2,0,9,3,1,9,11,1,3,5,0,6,6,1
Nicholls St,15,9,9,3,6,6,15,5,1,4,4,1,11,1,0,10,11,0,3,6,0,7,5,0
Norfolk State,16,8,9,1,5,7,15,6,0,6,2,0,9,4,0,11,10,0,5,3,0,6,7,0
Fairleigh,10,15,6,4,4,11,15,7,0,3,4,0,12,3,0,8,13,1,2,5,0,6,8,1
UC Irvine,20,4,8,1,9,3,15,8,0,7,3,0,8,5,0,10,13,0,5,5,0,5,8,0
Wisconsin,19,5,12,1,4,4,15,8,1,7,6,1,8,2,0,14,10,0,7,7,0,7,3,0
UNC Wilmington,20,5,13,2,7,3,15,8,0,9,4,0,6,4,0,13,9,1,9,3,1,4,6,0
Creighton,18,6,12,1,5,3,15,8,1,8,6,1,7,2,0,10,14,0,6,9,0,4,5,0
St. John's,21,3,15,0,5,1,15,8,1,10,6,0,5,2,1,10,14,0,8,8,0,2,6,0
VCU,19,5,12,0,4,3,15,8,0,10,4,0,5,4,0,14,9,0,8,6,0,6,3,0
North Alabama,17,8,10,1,6,7,15,8,0,8,1,0,7,7,0,11,12,0,6,3,0,5,9,0
N. Iowa,16,9,12,2,4,4,15,9,0,10,4,0,5,5,0,8,16,0,6,8,0,2,8,0
Tennessee,20,4,13,1,4,3,15,9,0,10,6,0,5,3,0,9,15,0,7,9,0,2,6,0
Nebraska,16,8,10,2,4,5,15,9,0,9,5,0,6,4,0,12,12,0,8,6,0,4,6,0
St. Bonaventure,17,8,10,3,5,4,15,9,0,8,5,0,7,4,0,11,13,0,5,8,0,6,5,0
Detroit,8,18,6,5,2,11,15,10,0,7,4,0,8,6,0,10,15,0,5,6,0,5,9,0
Long Island,12,15,7,4,5,9,15,10,0,7,2,0,8,8,0,10,15,0,2,7,0,8,8,0
Florida A&M,9,12,6,2,3,10,14,5,0,5,1,0,9,4,0,8,11,0,2,4,0,6,7,0
Jax State,17,7,11,0,5,5,14,7,0,6,4,0,8,3,0,8,11,2,2,8,0,6,3,2
Liberty,19,5,10,2,5,2,14,7,0,7,4,0,7,3,0,9,12,0,4,7,0,5,5,0
SE Missouri,15,10,9,3,6,6,14,8,0,7,3,0,7,5,0,13,9,0,8,2,0,5,7,0
SIU-Edwardsville,17,8,10,1,6,7,14,8,1,8,2,0,6,6,1,9,14,0,5,5,0,4,9,0
UC Davis,14,10,7,2,7,8,14,8,0,4,3,0,10,5,0,7,14,1,1,5,1,6,9,0
Utah Valley,17,7,10,0,6,6,14,8,0,8,1,0,6,7,0,12,10,0,6,3,0,6,7,0
Campbell,13,11,7,4,6,7,14,8,0,5,4,0,9,4,0,8,14,0,0,9,0,8,5,0
UIC,14,10,6,5,7,3,14,8,0,4,6,0,10,2,0,15,7,0,7,3,0,8,4,0
Cleveland St,18,7,12,2,6,5,14,8,0,6,5,0,8,3,0,9,13,0,4,7,0,5,6,0
Michigan St,19,4,12,0,3,2,14,8,1,10,6,0,4,2,1,9,14,0,5,11,0,4,3,0
Arizona,17,6,11,1,5,2,14,9,0,9,6,0,5,3,0,14,9,0,9,6,0,5,3,0
Iowa State,18,5,12,1,4,3,14,9,0,10,5,0,4,4,0,10,13,0,5,10,0,5,3,0
Ark-Little Rock,16,9,7,3,9,5,14,9,0,4,5,0,10,4,0,6,17,0,1,8,0,5,9,0
Chattanooga,17,8,10,3,7,5,14,9,0,6,5,0,8,4,0,12,10,1,6,4,1,6,6,0
Duke,20,3,13,0,7,1,14,9,0,8,6,0,6,3,0,10,13,0,7,7,0,3,6,0
Jacksonville,15,9,8,3,6,5,14,9,0,7,4,0,7,5,0,10,13,0,2,9,0,8,4,0
Vanderbilt,17,6,12,1,2,4,14,9,0,10,5,0,4,4,0,12,11,0,8,7,0,4,4,0
Maine,16,9,8,1,6,8,14,9,0,6,2,0,8,7,0,12,11,0,4,4,0,8,7,0
Elon,15,10,9,2,5,7,14,9,0,7,3,0,7,6,0,9,14,0,4,6,0,5,8,0
Louisville,18,6,10,3,6,2,14,10,0,5,9,0,9,1,0,8,16,0,4,10,0,4,6,0
Clemson,19,5,12,2,5,3,14,10,0,8,7,0,6,3,0,12,12,0,9,6,0,3,6,0
Lafayette,10,15,7,5,3,10,14,10,0,6,5,0,8,5,0,12,11,1,4,6,1,8,5,0
New Mexico,20,4,12,1,6,2,14,10,0,9,5,0,5,5,0,12,12,0,10,4,0,2,8,0
Ole Miss,18,6,11,2,4,3,14,10,0,8,7,0,6,3,0,10,14,0,6,9,0,4,5,0
Purdue,19,5,12,1,5,2,14,10,0,8,6,0,6,4,0,14,9,1,9,4,1,5,5,0
Ohio State,14,10,9,4,3,5,14,10,0,9,5,0,5,5,0,11,13,0,6,8,0,5,5,0
Charleston,19,6,11,2,5,3,14,10,0,7,6,0,7,4,0,13,11,0,9,4,0,4,7,0
Iona,11,13,5,5,5,6,14,10,0,6,5,0,8,5,0,13,11,0,6,5,0,7,6,0
FGCU,14,11,8,4,6,7,14,11,0,5,7,0,9,4,0,12,13,0,4,8,0,8,5,0
Monmouth,8,17,6,2,2,12,14,11,0,6,3,0,8,8,0,10,15,0,5,4,0,5,11,0
Washington St,16,10,9,2,3,6,14,12,0,10,5,0,4,7,0,13,13,0,10,5,0,3,8,0
Yale,14,6,7,0,5,5,13,5,1,6,1,0,7,4,1,12,7,0,3,4,0,9,3,0
Idaho State,11,11,8,3,3,8,13,6,0,5,3,0,8,3,0,11,8,0,5,3,0,6,5,0
SE Louisiana,15,9,6,2,8,6,13,7,2,2,3,1,11,4,1,9,13,0,4,2,0,5,11,0
UNC Asheville,17,7,11,0,5,7,13,7,0,6,1,0,7,6,0,11,7,2,4,3,0,7,4,2
Manhattan,11,10,6,4,5,6,13,7,0,5,4,0,8,3,0,13,7,0,6,3,0,7,4,0
Portland State,14,10,8,1,5,8,13,8,0,5,2,0,8,6,0,10,11,0,1,6,0,9,5,0
Texas A&M,18,5,10,1,4,3,13,8,2,7,4,1,6,4,1,8,15,0,4,8,0,4,7,0
Arkansas St,18,7,11,0,6,5,13,9,2,6,5,1,7,4,1,10,14,0,4,8,0,6,6,0
CS Northridge,17,7,7,2,8,5,13,9,0,5,3,0,8,6,0,11,11,0,2,6,0,9,5,0
Kennesaw St,14,10,11,2,2,6,13,9,0,8,4,0,5,5,0,8,13,1,3,8,1,5,5,0
Fresno State,5,19,4,7,1,10,13,9,2,7,3,2,6,6,0,15,9,0,7,5,0,8,4,0
Auburn,21,2,10,1,5,1,13,9,1,8,4,1,5,5,0,14,9,0,8,5,0,6,4,0
Toledo,15,8,7,2,6,5,13,9,0,3,7,0,10,2,0,11,11,0,4,6,0,7,5,0
Binghamton,12,13,7,3,4,9,13,9,0,6,2,0,7,7,0,9,12,1,3,5,0,6,7,1
St. Mary's,13,10,6,4,7,6,13,9,0,4,5,0,9,4,0,11,11,0,4,5,0,7,6,0
Davidson,14,9,11,2,2,5,13,9,0,8,6,0,5,3,0,11,11,0,6,8,0,5,3,0
St. Thomas,19,7,11,0,7,6,13,9,1,6,3,0,7,6,1,16,6,1,5,3,1,11,3,0
Arizona St,12,11,5,5,2,5,13,10,0,7,7,0,6,3,0,10,13,0,7,7,0,3,6,0
UCLA,18,6,13,1,3,3,13,10,1,10,5,1,3,5,0,10,14,0,5,11,0,5,3,0
Texas,15,9,10,4,3,4,13,10,1,8,7,1,5,3,0,13,11,0,10,6,0,3,5,0
K State,12,11,8,3,2,6,13,10,0,8,7,0,5,3,0,11,12,0,8,7,0,3,5,0
West Virginia,15,8,10,3,3,4,13,10,0,8,7,0,5,3,0,6,16,1,3,12,0,3,4,1
Texas Tech,18,5,12,2,5,1,13,10,0,9,7,0,4,3,0,13,10,0,8,8,0,5,2,0
NDSU,17,9,8,4,7,5,13,10,0,4,6,0,9,4,0,15,7,1,6,3,1,9,4,0
Southern Miss,10,15,9,2,1,11,13,10,0,7,4,0,6,6,0,8,14,1,3,8,0,5,6,1
UAB,15,8,11,3,3,3,13,10,0,8,7,0,5,3,0,12,11,0,7,8,0,5,3,0
Jackson St,7,16,4,1,3,14,13,10,0,4,2,0,9,8,0,13,10,0,4,2,0,9,8,0
American U,15,10,8,1,4,9,13,10,0,7,3,0,6,7,0,15,8,0,6,4,0,9,4,0
Radford,16,10,8,2,6,8,13,10,1,4,4,0,9,6,1,13,11,0,8,0,0,5,11,0
Missouri,17,6,15,1,2,4,13,10,0,9,8,0,4,2,0,11,12,0,8,9,0,3,3,0
Alabama,20,3,10,1,7,1,13,10,0,8,7,0,5,3,0,10,11,2,6,8,1,4,3,1
Georgetown,15,9,12,4,3,5,13,10,1,8,7,1,5,3,0,8,16,0,6,10,0,2,6,0
Queens,15,10,8,4,6,6,13,10,0,6,5,0,7,5,0,11,12,0,8,3,0,3,9,0
Lakers,13,14,9,2,4,12,13,10,0,6,2,0,7,8,0,13,10,0,5,3,0,8,7,0
Georgia State,10,15,7,6,2,8,13,11,0,8,6,0,5,5,0,14,10,0,8,6,0,6,4,0
N.J.I.T.,5,20,4,6,0,14,13,11,0,4,5,0,9,6,0,14,10,0,3,6,0,11,4,0
Bucknell,11,14,8,3,3,10,13,11,1,5,6,0,8,5,1,14,11,0,6,5,0,8,6,0
Indiana,14,10,11,3,2,5,13,11,0,9,6,0,4,5,0,12,12,0,7,8,0,5,4,0
Santa Clara,17,9,10,3,4,4,13,13,0,9,8,0,4,5,0,13,13,0,9,8,0,4,5,0
Dartmouth,10,10,6,3,4,7,12,6,0,4,3,0,8,3,0,9,8,1,5,2,0,4,6,1
W. Kentucky,14,10,11,2,3,8,12,7,3,6,2,3,6,5,0,8,14,0,6,5,0,2,9,0
Morgan State,10,13,10,3,0,10,12,7,0,7,2,0,5,5,0,13,6,0,5,4,0,8,2,0
Middle Tenn,16,8,9,2,5,5,12,8,2,6,4,0,6,4,2,9,12,1,3,6,1,6,6,0
LA Tech,17,7,10,1,3,6,12,8,1,7,2,1,5,6,0,10,11,0,6,4,0,4,7,0
SC State,11,12,5,2,5,10,12,8,0,3,1,0,9,7,0,11,9,0,3,1,0,8,8,0
Miami (OH),18,5,11,1,5,4,12,8,1,6,3,1,6,5,0,14,7,0,7,3,0,7,4,0
Drake,22,2,12,1,6,1,12,9,1,5,6,1,7,3,0,9,13,0,4,8,0,5,5,0
Troy,15,9,10,3,5,6,12,9,1,6,5,0,6,4,1,8,14,0,7,4,0,1,10,0
UC Riverside,16,9,11,1,5,8,12,9,2,4,4,2,8,5,0,12,11,0,6,4,0,6,7,0
Marshall,15,10,12,3,3,7,12,9,2,8,4,1,4,5,1,9,13,1,5,8,0,4,5,1
NW State,10,13,7,3,3,10,12,9,0,3,5,0,9,4,0,5,14,2,2,5,1,3,9,1
Hampton,12,13,6,4,4,7,12,9,0,4,3,0,8,6,0,12,8,1,4,3,0,8,5,1
Akron,18,5,12,0,5,3,12,9,0,6,5,0,6,4,0,13,8,0,8,3,0,5,5,0
Washington,12,11,9,6,1,5,12,10,0,8,7,0,4,3,0,12,10,0,9,6,0,3,4,0
Tenn St,12,13,10,3,2,8,12,10,0,6,6,0,6,4,0,16,6,0,11,1,0,5,5,0
Indiana St,12,13,6,5,4,6,12,10,1,5,5,1,7,5,0,16,7,0,5,6,0,11,1,0
UNC Greensboro,16,9,9,2,6,5,12,10,0,5,5,0,7,5,0,11,10,1,6,4,0,5,6,1
SD State,16,9,11,0,2,7,12,10,0,8,3,0,4,7,0,10,12,0,7,4,0,3,8,0
C. Arkansas,6,19,6,5,0,13,12,10,1,5,4,0,7,6,1,14,9,0,6,3,0,8,6,0
B-Cookman,10,13,5,0,4,12,12,10,1,4,2,0,8,8,1,11,12,0,3,3,0,8,9,0
Florida St,14,9,9,3,1,6,12,10,0,10,3,0,2,7,0,9,13,0,5,8,0,4,5,0
Army,14,10,11,3,3,7,12,10,0,7,5,0,5,5,0,14,8,0,7,5,0,7,3,0
Presbyterian,10,15,7,4,1,11,12,10,0,4,4,0,8,6,0,7,15,0,4,4,0,3,11,0
Sacred Heart,11,12,6,3,4,8,12,10,0,6,3,0,6,7,0,11,11,0,2,7,0,9,4,0
St. Francis (PA),10,15,7,4,3,11,12,10,0,4,4,0,8,6,0,13,9,0,5,3,0,8,6,0
Delaware,12,13,8,4,3,8,12,10,1,6,4,1,6,6,0,15,8,0,7,4,0,8,4,0
California,12,12,10,5,2,6,12,11,1,6,8,1,6,3,0,11,13,0,9,6,0,2,7,0
TN-Martin,10,15,7,3,3,11,12,11,1,5,4,0,7,7,1,13,11,0,5,4,0,8,7,0
S. Alabama,16,9,10,4,6,5,12,11,0,5,7,0,7,4,0,7,16,0,4,8,0,3,8,0
N. Colorado,18,7,11,2,6,5,12,11,0,4,7,0,8,4,0,13,9,1,7,4,0,6,5,1
North Dakota,9,17,6,5,2,10,12,11,0,5,6,0,7,5,0,17,6,0,9,2,0,8,4,0
Houston,19,4,12,1,6,0,12,11,0,8,8,0,4,3,0,10,12,1,7,9,0,3,3,1
Samford,19,6,12,1,7,5,12,11,0,8,3,0,4,8,0,8,15,0,4,7,0,4,8,0
Denver,8,18,6,6,2,10,12,11,1,5,6,0,7,5,1,12,12,0,6,5,0,6,7,0
IUIN,8,18,5,6,3,10,12,11,0,4,5,0,8,6,0,15,8,0,5,4,0,10,4,0
Rice,12,12,6,5,4,5,12,11,0,6,7,0,6,4,0,12,11,0,7,6,0,5,5,0
Pittsburgh,14,9,10,3,3,5,12,11,0,8,5,0,4,6,0,13,9,1,8,4,1,5,5,0
Youngstown St,16,10,7,4,8,5,12,11,1,4,6,1,8,5,0,9,15,0,4,7,0,5,8,0
Boise State,17,7,11,1,3,4,12,11,0,9,5,0,3,6,0,12,11,0,7,7,0,5,4,0
Kentucky,16,7,12,2,2,4,12,11,0,8,7,0,4,4,0,13,10,0,9,6,0,4,4,0
Stony Brook,6,19,3,8,3,10,12,11,1,5,5,0,7,6,1,12,11,1,5,5,0,7,6,1
Towson,16,9,8,1,8,4,12,11,1,4,4,1,8,7,0,9,14,1,3,5,1,6,9,0
Pepperdine,9,15,6,6,2,8,12,11,1,7,6,0,5,5,1,13,11,0,6,7,0,7,4,0
BYU,15,8,11,2,2,5,12,11,0,10,6,0,2,5,0,12,11,0,8,8,0,4,3,0
UMASS,11,13,7,5,4,4,12,11,0,5,9,0,7,2,0,12,11,0,7,7,0,5,4,0
George Mason,19,5,14,1,5,4,12,11,0,7,7,0,5,4,0,10,13,0,8,6,0,2,7,0
Stanford,16,8,13,2,3,4,12,12,0,9,8,0,3,4,0,12,12,0,8,9,0,4,3,0
Wake Forest,18,6,11,1,5,4,12,12,0,7,8,0,5,4,0,9,15,0,5,10,0,4,5,0
Boston U,12,13,9,3,2,10,12,12,0,9,3,0,3,9,0,9,15,0,5,7,0,4,8,0
Gardner-Webb,9,15,5,4,2,11,12,12,0,4,6,0,8,6,0,16,7,1,7,2,1,9,5,0
Charleston So,9,17,6,4,3,11,12,12,0,4,5,0,8,7,0,13,10,1,4,5,0,9,5,1
Wright State,13,13,9,3,3,8,12,12,1,9,5,0,3,7,1,12,13,0,6,8,0,6,5,0
Georgia,16,8,13,2,1,5,12,12,0,11,6,0,1,6,0,8,16,0,8,9,0,0,7,0
Illinois,16,8,10,3,4,4,12,12,0,9,5,0,3,7,0,14,10,0,8,6,0,6,4,0
Saint Mary's,21,4,12,1,7,1,12,12,0,6,7,0,6,5,0,10,13,1,6,6,1,4,7,0
San Francisco,20,6,15,0,3,4,12,12,1,9,8,0,3,4,1,11,13,1,8,9,0,3,4,1
Xavier,14,10,11,2,2,7,12,12,0,8,7,0,4,5,0,10,13,1,6,9,0,4,4,1
Villanova,14,10,11,3,2,5,12,12,0,9,7,0,3,5,0,15,8,1,10,5,1,5,3,0
Providence,11,13,9,3,2,6,12,12,0,7,8,0,5,4,0,13,10,1,8,6,1,5,4,0
Wofford,13,12,7,3,5,8,12,13,0,5,6,0,7,7,0,12,12,1,6,4,1,6,8,0
San Diego,4,22,4,11,0,10,12,13,0,6,8,0,6,5,0,12,13,0,7,7,0,5,6,0
Pacific,8,19,5,8,1,11,12,13,0,5,7,0,7,6,0,10,15,0,6,6,0,4,9,0
Delaware St,12,10,7,1,3,9,11,7,0,3,2,0,8,5,0,10,8,0,2,3,0,8,5,0
UTEP,16,7,10,2,4,4,11,8,1,4,6,1,7,2,0,11,9,0,5,6,0,6,3,0
Kent State,15,8,7,4,6,3,11,8,2,4,6,1,7,2,1,6,15,0,6,5,0,0,10,0
Incarnate Word,11,13,8,5,2,8,11,9,0,4,5,0,7,4,0,9,10,1,3,5,1,6,5,0
Wyoming,11,13,7,5,3,6,11,9,3,6,5,0,5,4,3,10,13,0,5,6,0,5,7,0
C. Michigan,11,12,7,4,4,7,11,9,0,6,3,0,5,6,0,11,9,0,6,3,0,5,6,0
Montana,17,8,12,1,5,7,11,10,1,5,4,1,6,6,0,14,8,0,6,4,0,8,4,0
FIU,8,16,6,7,1,8,11,10,1,5,7,1,6,3,0,10,12,0,7,6,0,3,6,0
Syracuse,11,13,9,5,2,5,11,10,3,5,7,2,6,3,1,11,13,0,6,8,0,5,5,0
S. Illinois,12,13,6,5,5,5,11,11,1,4,8,0,7,3,1,11,12,0,5,7,0,6,5,0
App State,15,9,9,3,4,5,11,11,0,6,6,0,5,5,0,8,13,1,5,6,1,3,7,0
SMU,18,5,10,3,5,2,11,11,1,7,7,0,4,4,1,14,9,0,10,4,0,4,5,0
Mercer,11,14,6,4,4,9,11,11,1,6,3,1,5,8,0,11,12,0,3,7,0,8,5,0
Furman,18,7,10,2,7,5,11,11,1,4,6,0,7,5,1,12,11,0,5,5,0,7,6,0
McNeese St,18,6,10,1,6,2,11,11,0,5,6,0,6,5,0,10,11,1,6,4,1,4,7,0
Prairie View,4,19,2,4,2,15,11,11,0,3,2,0,8,9,0,12,10,0,4,1,0,8,9,0
Notre Dame,10,13,8,3,2,7,11,11,1,6,6,1,5,5,0,10,12,1,6,6,1,4,6,0
Holy Cross,12,13,6,4,4,9,11,11,1,4,5,0,7,6,1,12,11,0,4,5,0,8,6,0
G Washington,16,8,11,2,3,5,11,11,0,8,5,0,3,6,0,9,12,1,6,7,0,3,5,1
Tarleton St,10,15,8,1,1,12,11,11,0,5,3,0,6,8,0,10,12,0,4,4,0,6,8,0
Utah,13,10,12,3,1,5,11,12,0,9,6,0,2,6,0,9,14,0,6,9,0,3,5,0
E. Kentucky,14,11,7,3,6,6,11,12,0,3,6,0,8,6,0,15,8,0,5,4,0,10,4,0
Missouri St,8,17,6,6,1,9,11,12,1,5,7,0,6,5,1,12,12,0,6,6,0,6,6,0
Oklahoma,16,7,10,3,1,4,11,12,0,6,8,0,5,4,0,13,10,0,9,5,0,4,5,0
Idaho,11,14,7,5,4,8,11,12,0,5,5,0,6,7,0,15,8,0,6,4,0,9,4,0
UCF,13,10,10,4,2,4,11,12,0,7,10,0,4,2,0,14,9,0,8,9,0,6,0,0
Temple,14,10,10,0,2,7,11,12,0,6,5,0,5,7,0,18,5,0,9,2,0,9,3,0
Hawaii,13,11,11,5,2,6,11,12,0,7,8,0,4,4,0,12,9,2,7,7,1,5,2,1
Old Dominion,11,14,7,7,4,4,11,12,0,7,7,0,4,5,0,7,15,1,3,10,1,4,5,0
Winthrop,17,9,14,1,3,8,11,12,0,5,7,0,6,5,0,14,9,0,9,3,0,5,6,0
Oakland,10,15,6,4,3,9,11,12,1,6,4,1,5,8,0,11,13,0,6,5,0,5,8,0
Colorado St,15,8,10,2,4,3,11,12,0,8,7,0,3,5,0,13,10,0,9,6,0,4,4,0
Nevada,13,10,9,4,2,5,11,12,0,9,7,0,2,5,0,10,13,0,7,9,0,3,4,0
S. Carolina,10,13,8,6,1,6,11,12,0,9,6,0,2,6,0,8,15,0,6,9,0,2,6,0
Mississippi St,17,6,8,3,5,2,11,12,0,7,9,0,4,3,0,12,11,0,9,7,0,3,4,0
Maryland,18,6,14,1,2,5,11,12,1,9,7,1,2,5,0,15,9,0,10,7,0,5,2,0
Northwestern,13,11,11,3,0,7,11,12,1,6,8,1,5,4,0,18,6,0,11,4,0,7,2,0
Rutgers,12,12,9,3,2,5,11,12,1,8,7,0,3,5,1,13,10,1,7,7,1,6,3,0
Michigan,18,5,11,0,5,2,11,12,0,6,5,0,5,7,0,13,10,0,7,4,0,6,6,0
Butler,11,13,8,6,1,6,11,12,1,5,10,0,6,2,1,14,10,0,7,8,0,7,2,0
Dayton,16,8,13,2,2,3,11,12,0,8,8,0,3,4,0,15,8,0,11,5,0,4,3,0
Merrimack,14,10,7,2,7,7,11,12,1,3,6,0,8,6,1,9,15,0,0,9,0,9,6,0
Morehead St,14,11,9,3,5,7,11,13,0,3,9,0,8,4,0,9,15,0,5,7,0,4,8,0
Memphis,20,4,10,2,7,1,11,13,0,4,8,0,7,5,0,13,11,0,8,4,0,5,7,0
Virginia,12,12,9,5,2,5,11,13,0,7,9,0,4,4,0,14,10,0,8,8,0,6,2,0
Navy,8,17,5,5,3,10,11,13,0,3,7,0,8,6,0,13,11,0,8,2,0,5,9,0
Colgate,10,15,7,3,3,10,11,13,0,4,6,0,7,7,0,12,12,0,4,6,0,8,6,0
Penn State,13,11,10,4,1,6,11,13,0,6,8,0,5,5,0,8,15,1,7,6,1,1,9,0
DePaul,11,13,10,6,1,7,11,13,0,9,7,0,2,6,0,14,10,0,9,7,0,5,3,0
Chicago St,4,21,3,5,1,14,11,14,0,3,6,0,8,8,0,13,12,0,5,4,0,8,8,0
Cornell,13,7,6,5,7,2,10,7,1,3,6,0,7,1,1,11,7,0,5,4,0,6,3,0
North Texas,17,6,12,1,4,4,10,9,2,6,6,1,4,3,1,10,10,1,8,5,0,2,5,1
E Tennessee St,15,10,11,3,4,7,10,10,3,6,4,2,4,6,1,9,14,0,6,6,0,3,8,0
South Dakota,15,10,11,1,4,9,10,10,2,5,3,1,5,7,1,18,4,0,9,0,0,9,4,0
UTSA,10,13,6,5,3,8,10,10,1,4,5,1,6,5,0,14,7,0,7,3,0,7,4,0
UT Grande Valley,13,11,9,3,2,8,10,10,0,3,5,0,7,5,0,10,9,1,4,4,0,6,5,1
Lamar,14,10,8,3,6,5,10,10,1,2,7,0,8,3,1,9,12,0,3,6,0,6,6,0
N. Arizona,14,11,9,3,5,7,10,11,0,4,4,0,6,7,0,15,6,0,5,3,0,10,3,0
Tulane,13,11,10,3,3,5,10,11,1,6,6,0,4,5,1,8,13,1,2,9,1,6,4,0
Southern U,15,8,8,0,7,8,10,11,0,2,4,0,8,7,0,10,11,0,4,2,0,6,9,0
Lipscomb,17,8,8,3,9,5,10,11,2,4,5,0,6,6,2,8,15,0,5,4,0,3,11,0
Loyola Marymount,14,10,10,4,2,6,10,11,2,6,6,2,4,5,0,10,12,1,8,5,1,2,7,0
Fordham,11,12,8,4,2,6,10,11,0,5,7,0,5,4,0,14,7,0,8,4,0,6,3,0
Southern Indiana,9,15,7,6,2,9,10,11,1,4,7,0,6,4,1,11,11,0,6,5,0,5,6,0
Utah Tech,6,17,5,4,0,12,10,11,0,6,2,0,4,9,0,9,12,0,3,5,0,6,7,0
Belmont,17,8,9,4,7,3,10,12,2,4,8,2,6,4,0,17,7,0,11,3,0,6,4,0
Tenn Tech,13,12,7,3,5,8,10,12,1,3,6,1,7,6,0,11,12,0,4,6,0,7,6,0
Kansas,16,7,11,2,3,5,10,12,1,6,7,1,4,5,0,6,17,0,4,10,0,2,7,0
Texas St,12,13,7,3,3,9,10,12,1,5,5,0,5,7,1,14,8,1,6,4,0,8,4,1
UT-Arlington,11,13,7,2,3,9,10,12,0,3,6,0,7,6,0,10,12,0,3,6,0,7,6,0
Southern Utah,10,14,7,5,2,9,10,12,0,4,7,0,6,5,0,8,14,0,5,6,0,3,8,0
UMKC,11,15,8,4,2,9,10,12,0,6,3,0,4,9,0,8,14,0,5,4,0,3,10,0
Loyola (MD),10,13,5,5,5,8,10,12,0,3,6,0,7,6,0,15,7,0,6,3,0,9,4,0
Longwood,16,9,11,2,4,5,10,12,0,5,5,0,5,7,0,14,8,0,5,5,0,9,3,0
Valparaiso,10,15,8,6,2,8,10,12,1,6,7,0,4,5,1,14,9,0,8,5,0,6,4,0
LSU,12,11,10,4,1,5,10,12,1,7,8,0,3,4,1,11,12,0,9,6,0,2,6,0
UMBC,11,14,6,7,5,7,10,12,0,3,7,0,7,5,0,15,6,1,6,3,1,9,3,0
Hofstra,12,13,5,6,4,6,10,12,1,3,7,0,7,5,1,9,13,1,5,5,0,4,8,1
E TA&M,3,21,3,7,0,14,10,12,2,3,6,1,7,6,1,12,12,0,5,5,0,7,7,0
USC,13,10,10,5,3,3,10,13,0,6,9,0,4,4,0,17,6,0,10,5,0,7,1,0
Austin Peay,10,15,6,4,3,10,10,13,0,4,5,0,6,8,0,10,13,0,4,5,0,6,8,0
Bradley,19,6,10,3,6,2,10,13,1,5,7,1,5,6,0,15,9,0,7,6,0,8,3,0
Coastal Car,8,17,5,5,2,12,10,13,0,3,6,0,7,7,0,11,12,0,4,5,0,7,7,0
UConn,16,7,10,2,5,2,10,13,0,6,8,0,4,5,0,12,11,0,6,8,0,6,3,0
Cal Poly,9,15,6,4,3,11,10,13,0,4,5,0,6,8,0,14,9,0,4,5,0,10,4,0
Charlotte,9,15,7,6,1,8,10,13,0,6,8,0,4,5,0,12,11,0,7,7,0,5,4,0
NC A&T,4,20,3,8,1,12,10,13,0,2,8,0,8,5,0,14,9,0,4,6,0,10,3,0
VA Tech,11,13,7,6,4,3,10,13,1,5,10,1,5,3,0,11,13,0,9,7,0,2,6,0
North Florida,13,12,7,5,6,7,10,13,1,3,7,1,7,6,0,19,5,0,9,2,0,10,3,0
USC Upstate,5,21,4,7,1,13,10,13,0,3,5,0,7,8,0,15,8,0,5,3,0,10,5,0
Stetson,7,18,4,7,3,8,10,13,0,3,9,0,7,4,0,12,11,0,7,5,0,5,6,0
Milwaukee,16,9,9,2,6,7,10,13,0,5,5,0,5,8,0,11,12,0,7,3,0,4,9,0
Utah State,21,3,11,2,7,1,10,13,0,6,7,0,4,6,0,10,12,1,7,6,0,3,6,1
Bryant U,15,10,6,3,8,6,10,13,0,3,5,0,7,8,0,12,9,2,2,5,1,10,4,1
William & Mary,14,11,10,0,3,10,10,13,0,5,4,0,5,9,0,13,10,0,4,5,0,9,5,0
Portland,8,17,6,7,2,7,10,13,0,4,9,0,6,4,0,13,10,0,8,5,0,5,5,0
Marquette,18,6,11,2,6,4,10,13,1,6,7,1,4,6,0,10,14,0,8,6,0,2,8,0
La Salle,12,12,9,3,2,6,10,13,0,7,5,0,3,8,0,12,11,0,6,6,0,6,5,0
Duquesne,10,14,7,6,1,5,10,13,0,7,8,0,3,5,0,9,14,0,6,9,0,3,5,0
Oregon,16,8,8,4,4,4,10,14,0,3,9,0,7,5,0,14,10,0,7,5,0,7,5,0
Evansville,9,16,6,8,3,8,10,14,0,6,7,0,4,7,0,9,15,0,6,7,0,3,8,0
New Orleans,4,20,0,7,3,12,10,14,0,2,6,0,8,8,0,13,11,0,5,3,0,8,8,0
G Tech,11,13,10,5,1,7,10,14,0,7,9,0,3,5,0,10,14,0,6,10,0,4,4,0
UNLV,12,12,9,4,3,6,10,14,0,5,9,0,5,5,0,11,13,0,4,10,0,7,3,0
Northeastern,13,12,5,4,6,7,10,14,1,5,5,0,5,9,1,17,7,1,7,2,1,10,5,0
Rider,9,15,3,6,6,9,10,14,0,3,6,0,7,8,0,10,14,0,4,5,0,6,9,0
Wolves,4,21,3,6,1,13,10,14,0,4,5,0,6,9,0,15,9,0,6,3,0,9,6,0
Louisiana,8,17,4,10,4,4,10,15,0,5,10,0,5,5,0,9,16,0,4,11,0,5,5,0
NC Central,10,14,7,3,2,10,9,10,1,3,3,1,6,7,0,14,6,0,5,2,0,9,4,0
Brown,10,10,5,4,5,6,9,10,0,4,4,0,5,6,0,8,11,0,4,4,0,4,7,0
St. Peter's,7,13,2,5,5,8,9,10,0,1,5,0,8,5,0,10,9,0,2,4,0,8,5,0
E. Carolina,13,11,8,6,3,4,9,11,2,5,7,1,4,4,1,13,9,0,7,6,0,6,3,0
FAU,13,10,6,3,4,5,9,11,2,5,5,1,4,6,1,12,10,0,6,5,0,6,5,0
Texas A&M-CC,15,10,11,2,4,8,9,11,1,5,4,0,4,7,1,13,8,0,3,6,0,10,2,0
N. Illinois,5,18,5,6,0,12,9,11,0,4,4,0,5,7,0,8,12,0,1,7,0,7,5,0
Bowling Green,9,14,7,5,1,8,9,11,1,6,5,1,3,6,0,11,10,0,4,8,0,7,2,0
Seattle,10,13,8,4,2,8,9,12,0,4,7,0,5,5,0,9,12,0,3,8,0,6,4,0
Lehigh,9,14,7,4,2,10,9,12,0,4,5,0,5,7,0,8,13,0,4,5,0,4,8,0
Ball State,11,12,5,5,4,6,9,12,0,2,8,0,7,4,0,12,9,0,5,5,0,7,4,0
Buffalo,7,16,5,6,2,10,9,12,0,3,6,0,6,6,0,11,10,0,3,6,0,8,4,0
Marist,16,5,9,2,7,3,9,12,0,4,7,0,5,5,0,10,11,0,4,7,0,6,4,0
Stonehill,12,13,8,3,3,9,9,12,2,4,5,1,5,7,1,11,11,1,5,5,0,6,6,1
E. Illinois,8,17,5,5,2,12,9,13,0,2,5,0,7,8,0,10,12,0,3,4,0,7,8,0
Baylor,15,8,11,1,2,6,9,13,0,8,4,0,1,9,0,13,9,0,8,4,0,5,5,0
Tulsa,9,15,7,7,1,6,9,13,0,4,8,0,5,5,0,9,13,0,5,7,0,4,6,0
E. Michigan,11,12,6,4,4,8,9,13,0,5,5,0,4,8,0,14,8,0,8,2,0,6,6,0
W. Michigan,7,16,4,7,3,9,9,13,0,2,8,0,7,5,0,10,11,1,4,6,0,6,5,1
Iowa,13,10,11,4,0,5,9,13,1,8,8,1,1,5,0,13,10,0,9,8,0,4,2,0
Rhode Island,15,8,11,2,1,6,9,13,0,7,7,0,2,6,0,14,8,0,9,5,0,5,3,0
Saint Joe's,14,9,9,4,2,4,9,13,1,6,9,1,3,4,0,12,11,0,8,8,0,4,3,0
Quinnipiac,14,10,9,2,5,8,9,13,1,5,4,1,4,9,0,12,11,0,6,4,0,6,7,0
Fairfield,9,15,6,5,2,9,9,13,1,6,5,0,3,8,1,11,11,1,3,7,1,8,4,0
Niagara,9,14,5,4,2,10,9,13,0,5,5,0,4,8,0,11,11,0,6,4,0,5,7,0
Murray State,12,13,5,5,5,6,9,14,1,3,8,0,6,6,1,14,10,0,4,7,0,10,3,0
OK State,12,11,9,2,2,6,9,14,0,5,8,0,4,6,0,12,11,0,7,6,0,5,5,0
GA Southern,13,12,8,2,4,9,9,14,1,4,6,0,5,8,1,12,12,0,6,4,0,6,8,0
Cincinnati,14,9,9,4,4,5,9,14,0,5,9,0,4,5,0,5,18,0,4,10,0,1,8,0
LBSU,7,18,3,8,4,7,9,14,0,3,7,0,6,7,0,15,8,0,6,4,0,9,4,0
Green Bay,2,23,1,9,1,14,9,14,1,2,7,0,7,7,1,10,12,2,3,6,0,7,6,2
JMU,15,10,11,2,2,7,9,14,0,6,5,0,3,9,0,8,15,0,3,8,0,5,7,0
Seton Hall,6,18,4,8,0,8,9,14,0,5,8,0,4,6,0,11,12,0,5,8,0,6,4,0
Montana St,10,15,8,2,2,13,9,15,0,5,4,0,4,11,0,11,13,0,3,6,0,8,7,0
High Point,21,5,13,1,5,3,9,15,0,6,8,0,3,7,0,14,10,0,6,8,0,8,2,0
Gonzaga,18,7,11,1,5,2,9,16,0,5,10,0,4,6,0,15,10,0,10,5,0,5,5,0
Columbia,12,8,9,4,3,4,8,10,0,6,5,0,2,5,0,9,8,1,5,6,0,4,2,1
W. Carolina,6,17,5,6,1,11,8,11,0,2,6,0,6,5,0,11,7,1,4,3,1,7,4,0
Harvard,7,13,3,4,4,9,8,11,0,3,3,0,5,8,0,8,11,0,4,2,0,4,9,0
Wichita State,13,10,8,4,3,5,8,12,2,4,7,2,4,5,0,8,14,0,3,10,0,5,4,0
Sac State,6,18,5,7,1,11,8,12,1,2,7,0,6,5,1,8,13,0,4,5,0,4,8,0
UCSB,16,8,10,4,6,4,8,12,2,5,7,0,3,5,2,10,12,0,7,5,0,3,7,0
N. Mexico St,12,11,7,4,5,5,8,12,0,2,7,0,6,5,0,7,13,0,3,6,0,4,7,0
Grambling St,7,16,4,4,3,10,8,12,0,1,5,0,7,7,0,8,11,1,3,3,0,5,8,1
Coppin St,4,18,3,4,1,14,8,12,1,3,3,0,5,9,1,10,11,0,2,4,0,8,7,0
San Diego State,15,6,8,3,4,2,8,12,0,3,9,0,5,3,0,9,11,0,5,7,0,4,4,0
UMass Lowell,15,9,12,2,3,7,8,12,1,3,7,1,5,5,0,10,11,0,6,5,0,4,6,0
Penn,6,14,4,7,2,6,8,12,0,4,8,0,4,4,0,11,7,2,9,3,0,2,4,2
Ab Christian,11,13,6,4,4,9,8,13,0,2,5,0,6,8,0,11,10,0,1,6,0,10,4,0
AR-Pine Bluff,4,19,4,4,0,15,8,13,0,3,3,0,5,10,0,13,8,0,3,3,0,10,5,0
MS Valley St,3,20,2,4,1,16,8,13,0,3,1,0,5,12,0,10,11,0,0,4,0,10,7,0
Lindenwood,11,14,9,3,1,10,8,13,1,6,3,1,2,10,0,12,10,0,6,4,0,6,6,0
Loyola (IL),14,9,12,1,2,4,8,14,0,4,10,0,4,4,0,10,12,0,6,8,0,4,4,0
CS Bakersfield,10,15,7,4,2,10,8,14,1,6,4,0,2,10,1,15,8,0,7,3,0,8,5,0
NC State,9,14,9,5,0,7,8,14,1,6,9,0,2,5,1,8,15,0,4,11,0,4,4,0
Arkansas,14,9,9,4,3,3,8,14,1,6,8,1,2,6,0,9,14,0,5,10,0,4,4,0
Ohio,12,11,9,2,2,7,8,14,0,6,4,0,2,10,0,14,7,1,6,3,1,8,4,0
Saint Louis,14,10,11,2,3,6,8,14,0,5,6,0,3,8,0,4,18,0,2,9,0,2,9,0
Colorado,9,14,8,6,0,6,8,15,0,7,8,0,1,7,0,9,12,2,7,6,2,2,6,0
TCU,12,11,11,2,1,6,8,15,0,6,8,0,2,7,0,6,16,1,3,10,1,3,6,0
UL Monroe,6,19,4,8,2,10,8,15,0,3,8,0,5,7,0,9,14,0,5,6,0,4,8,0
Boston Col,10,13,7,6,0,6,8,15,0,6,10,0,2,5,0,14,9,0,9,7,0,5,2,0
Albany,12,13,5,6,5,6,8,15,0,3,8,0,5,7,0,11,12,0,4,7,0,7,5,0
New Hampshire,6,19,5,6,1,11,8,15,0,5,5,0,3,10,0,11,12,0,5,5,0,6,7,0
Canisius,2,21,1,9,1,11,8,15,0,4,6,0,4,9,0,13,10,0,5,5,0,8,5,0
Cal Baptist,12,11,8,5,3,5,8,15,0,4,10,0,4,5,0,12,11,0,8,6,0,4,5,0
S. Florida,12,12,9,3,1,7,8,16,0,5,9,0,3,7,0,10,14,0,7,7,0,3,7,0
Air Force,3,21,2,11,0,10,8,16,0,4,10,0,4,6,0,15,8,1,8,5,1,7,3,0
Oral Roberts,6,17,6,6,0,11,7,12,0,4,4,0,3,8,0,11,8,0,4,4,0,7,4,0
Citadel,5,18,5,9,0,9,7,13,0,3,8,0,4,5,0,10,10,0,6,5,0,4,5,0
SFA,11,13,7,6,4,7,7,13,1,2,8,0,5,5,1,8,13,0,4,6,0,4,7,0
Texas Southern,10,13,7,3,3,10,7,13,0,3,4,0,4,9,0,8,11,1,1,5,1,7,6,0
Wagner,12,12,7,5,5,7,7,13,0,2,6,0,5,7,0,8,12,0,5,3,0,3,9,0
CS Fullerton,6,19,4,8,2,11,7,14,2,3,5,2,4,9,0,10,12,1,6,4,0,4,8,1
Grand Canyon,17,6,13,1,2,3,7,15,0,4,10,0,3,5,0,10,12,0,7,7,0,3,5,0
Alabama St,9,14,5,2,2,10,7,15,0,2,5,0,5,10,0,11,11,0,5,2,0,6,9,0
Minnesota,12,12,10,6,2,4,7,15,2,4,11,1,3,4,1,12,12,0,10,6,0,2,6,0
E. Washington,9,16,7,4,2,11,7,16,0,3,6,0,4,10,0,11,12,0,5,4,0,6,8,0
Miami (FL),5,18,5,8,0,6,7,16,0,4,9,0,3,7,0,14,9,0,8,5,0,6,4,0
Richmond,8,16,5,6,1,9,7,16,0,4,7,0,3,9,0,11,12,0,6,5,0,5,7,0
Bellarmine,3,22,3,8,0,14,7,16,0,1,8,0,6,8,0,13,10,0,5,4,0,8,6,0
Dolphins,7,18,4,5,2,13,7,16,0,3,5,0,4,11,0,16,7,0,6,2,0,10,5,0
UNC,14,10,9,2,3,5,7,17,0,5,10,0,2,7,0,11,13,0,7,8,0,4,5,0
MD-E Shore,4,18,4,3,0,15,6,11,1,1,2,0,5,9,1,6,12,0,0,3,0,6,9,0
Howard,9,14,7,5,1,7,6,12,0,2,6,0,4,6,0,13,5,0,7,1,0,6,4,0
Alabama A&M,7,16,7,7,0,9,6,14,0,6,5,0,0,9,0,14,6,0,9,2,0,5,4,0
Princeton,16,6,7,3,6,1,6,14,0,3,8,0,3,6,0,7,13,0,4,7,0,3,6,0
Weber State,9,16,4,8,3,8,6,15,1,2,7,0,4,8,1,13,9,0,5,4,0,8,5,0
Vermont,13,11,8,2,4,8,6,15,1,2,6,1,4,9,0,9,13,0,7,2,0,2,11,0
N Kentucky,11,14,9,6,2,8,6,19,0,5,10,0,1,9,0,9,15,1,4,10,1,5,5,0
W. Illinois,8,17,5,7,3,9,5,16,1,1,8,1,4,8,0,14,8,0,5,5,0,9,3,0
Sam Houston,8,16,5,3,2,12,5,16,0,1,5,0,4,11,0,13,8,0,5,1,0,8,7,0
Panthers,0,5,0,0,0,2,2,1,0,1,0,0,1,1,0,0,3,0,0,1,0,0,2,0
Tigers,0,1,0,0,0,1,1,0,0,0,0,0,1,0,0,0,1,0,0,0,0,0,1,0
Thorobreds,0,1,0,0,0,1,1,0,0,0,0,0,1,0,0,0,1,0,0,0,0,0,1,0
Toccoa Falls Eagles,0,3,0,0,0,3,1,0,0,0,0,0,1,0,0,1,0,0,0,0,0,1,0,0
Franklin College,0,1,0,0,0,1,1,0,0,0,0,0,1,0,0,0,1,0,0,0,0,0,1,0
Alice Lloyd Eagles,0,2,0,0,0,2,1,0,0,0,0,0,1,0,0,0,1,0,0,0,0,0,1,0
U of the Cumberlands,0,1,0,0,0,1,1,0,0,0,0,0,1,0,0,0,1,0,0,0,0,0,1,0
Champion Christian,0,5,0,0,0,5,1,0,0,0,0,0,1,0,0,1,0,0,0,0,0,1,0,0
Marauders,0,2,0,0,0,2,1,1,0,0,0,0,1,1,0,0,2,0,0,0,0,0,2,0
Flying Fleet,0,2,0,0,0,2,1,1,0,0,0,0,1,1,0,0,2,0,0,0,0,0,2,0
Life Pacific College,0,6,0,0,0,4,1,1,0,0,0,0,1,1,0,2,0,0,0,0,0,2,0,0
Montreat,0,2,0,0,0,2,1,1,0,0,0,0,1,1,0,1,1,0,0,0,0,1,1,0
Kentucky Christian,0,3,0,0,0,3,1,2,0,0,0,0,1,2,0,3,0,0,0,0,0,3,0,0
Savannah St,0,0,0,0,0,0,0,0,0,0,0,0,0,0,0,0,0,0,0,0,0,0,0,0
Hartford,0,0,0,0,0,0,0,0,0,0,0,0,0,0,0,0,0,0,0,0,0,0,0,0
Rams,0,0,0,0,0,0,0,0,0,0,0,0,0,0,0,0,0,0,0,0,0,0,0,0
Blue Bears,0,1,0,0,0,1,0,0,0,0,0,0,0,0,0,0,0,0,0,0,0,0,0,0
Trojans,0,0,0,0,0,0,0,0,0,0,0,0,0,0,0,0,0,0,0,0,0,0,0,0
Bears,0,0,0,0,0,0,0,0,0,0,0,0,0,0,0,0,0,0,0,0,0,0,0,0
Falcons,0,0,0,0,0,0,0,0,0,0,0,0,0,0,0,0,0,0,0,0,0,0,0,0
Vikings,0,1,0,0,0,1,0,0,0,0,0,0,0,0,0,0,0,0,0,0,0,0,0,0
Golden Bulls,0,0,0,0,0,0,0,0,0,0,0,0,0,0,0,0,0,0,0,0,0,0,0,0
Bulldogs,1,0,0,0,1,0,0,0,0,0,0,0,0,0,0,0,0,0,0,0,0,0,0,0
Lions,0,0,0,0,0,0,0,0,0,0,0,0,0,0,0,0,0,0,0,0,0,0,0,0
Broncos,0,0,0,0,0,0,0,0,0,0,0,0,0,0,0,0,0,0,0,0,0,0,0,0
Hawks,0,0,0,0,0,0,0,0,0,0,0,0,0,0,0,0,0,0,0,0,0,0,0,0
Panthers,0,0,0,0,0,0,0,0,0,0,0,0,0,0,0,0,0,0,0,0,0,0,0,0
Tigers,0,0,0,0,0,0,0,0,0,0,0,0,0,0,0,0,0,0,0,0,0,0,0,0
Flames,0,0,0,0,0,0,0,0,0,0,0,0,0,0,0,0,0,0,0,0,0,0,0,0
Hawks,0,0,0,0,0,0,0,0,0,0,0,0,0,0,0,0,0,0,0,0,0,0,0,0
Chargers,0,0,0,0,0,0,0,0,0,0,0,0,0,0,0,0,0,0,0,0,0,0,0,0
Blazers,0,0,0,0,0,0,0,0,0,0,0,0,0,0,0,0,0,0,0,0,0,0,0,0
Argonauts,0,0,0,0,0,0,0,0,0,0,0,0,0,0,0,0,0,0,0,0,0,0,0,0
Bulldogs,0,1,0,0,0,1,0,0,0,0,0,0,0,0,0,0,0,0,0,0,0,0,0,0
Buccaneers,0,0,0,0,0,0,0,0,0,0,0,0,0,0,0,0,0,0,0,0,0,0,0,0
Statesmen,0,0,0,0,0,0,0,0,0,0,0,0,0,0,0,0,0,0,0,0,0,0,0,0
Choctaws,0,3,0,0,0,3,0,0,0,0,0,0,0,0,0,0,0,0,0,0,0,0,0,0
Bruins,0,4,0,0,0,4,0,0,0,0,0,0,0,0,0,0,0,0,0,0,0,0,0,0
Bulldogs,0,1,0,0,0,1,0,0,0,0,0,0,0,0,0,0,0,0,0,0,0,0,0,0
Red Lions,0,0,0,0,0,0,0,0,0,0,0,0,0,0,0,0,0,0,0,0,0,0,0,0
Bears,0,0,0,0,0,0,0,0,0,0,0,0,0,0,0,0,0,0,0,0,0,0,0,0
Suns,0,0,0,0,0,0,0,0,0,0,0,0,0,0,0,0,0,0,0,0,0,0,0,0
Patriots,0,2,0,0,0,2,0,0,0,0,0,0,0,0,0,0,0,0,0,0,0,0,0,0
Deacons,0,0,0,0,0,0,0,0,0,0,0,0,0,0,0,0,0,0,0,0,0,0,0,0
Fighting Scots,0,0,0,0,0,0,0,0,0,0,0,0,0,0,0,0,0,0,0,0,0,0,0,0
Yellow Jackets,0,0,0,0,0,0,0,0,0,0,0,0,0,0,0,0,0,0,0,0,0,0,0,0
Panthers,0,1,0,0,0,1,0,0,0,0,0,0,0,0,0,0,0,0,0,0,0,0,0,0
Bulldogs,0,0,0,0,0,0,0,0,0,0,0,0,0,0,0,0,0,0,0,0,0,0,0,0
Tigers,0,0,0,0,0,0,0,0,0,0,0,0,0,0,0,0,0,0,0,0,0,0,0,0
Trojans,0,0,0,0,0,0,0,0,0,0,0,0,0,0,0,0,0,0,0,0,0,0,0,0
Battlers,0,0,0,0,0,0,0,0,0,0,0,0,0,0,0,0,0,0,0,0,0,0,0,0
Senators,0,1,0,0,0,1,0,0,0,0,0,0,0,0,0,0,0,0,0,0,0,0,0,0
Tigers,0,0,0,0,0,0,0,0,0,0,0,0,0,0,0,0,0,0,0,0,0,0,0,0
Golden Eagles,0,0,0,0,0,0,0,0,0,0,0,0,0,0,0,0,0,0,0,0,0,0,0,0
Pioneers,0,0,0,0,0,0,0,0,0,0,0,0,0,0,0,0,0,0,0,0,0,0,0,0
Broncos,0,0,0,0,0,0,0,0,0,0,0,0,0,0,0,0,0,0,0,0,0,0,0,0
Gators,0,1,0,0,0,1,0,0,0,0,0,0,0,0,0,0,0,0,0,0,0,0,0,0
Coyotes,0,0,0,0,0,0,0,0,0,0,0,0,0,0,0,0,0,0,0,0,0,0,0,0
Seawolves,0,0,0,0,0,0,0,0,0,0,0,0,0,0,0,0,0,0,0,0,0,0,0,0
Toros,0,0,0,0,0,0,0,0,0,0,0,0,0,0,0,0,0,0,0,0,0,0,0,0
Jacks,0,0,0,0,0,0,0,0,0,0,0,0,0,0,0,0,0,0,0,0,0,0,0,0
Otters,0,0,0,0,0,0,0,0,0,0,0,0,0,0,0,0,0,0,0,0,0,0,0,0
Warriors,0,3,0,0,0,3,0,0,0,0,0,0,0,0,0,0,0,0,0,0,0,0,0,0
Wildcats,0,0,0,0,0,0,0,0,0,0,0,0,0,0,0,0,0,0,0,0,0,0,0,0
So Wesleyan,0,1,0,0,0,1,0,0,0,0,0,0,0,0,0,0,0,0,0,0,0,0,0,0
Crusaders,0,1,0,0,0,1,0,0,0,0,0,0,0,0,0,0,0,0,0,0,0,0,0,0
Crusaders,0,0,0,0,0,0,0,0,0,0,0,0,0,0,0,0,0,0,0,0,0,0,0,0
Limestone,0,0,0,0,0,0,0,0,0,0,0,0,0,0,0,0,0,0,0,0,0,0,0,0
Tornado,0,0,0,0,0,0,0,0,0,0,0,0,0,0,0,0,0,0,0,0,0,0,0,0
Falcons,0,2,0,0,0,2,0,0,0,0,0,0,0,0,0,0,0,0,0,0,0,0,0,0
Trojans,0,3,0,0,0,3,0,0,0,0,0,0,0,0,0,0,0,0,0,0,0,0,0,0
Bobcats,0,0,0,0,0,0,0,0,0,0,0,0,0,0,0,0,0,0,0,0,0,0,0,0
Bulldogs,0,0,0,0,0,0,0,0,0,0,0,0,0,0,0,0,0,0,0,0,0,0,0,0
Lions,0,0,0,0,0,0,0,0,0,0,0,0,0,0,0,0,0,0,0,0,0,0,0,0
Pumas,0,0,0,0,0,0,0,0,0,0,0,0,0,0,0,0,0,0,0,0,0,0,0,0
Panthers,0,0,0,0,0,0,0,0,0,0,0,0,0,0,0,0,0,0,0,0,0,0,0,0
Prairie Stars,0,0,0,0,0,0,0,0,0,0,0,0,0,0,0,0,0,0,0,0,0,0,0,0
Bearcats,0,0,0,0,0,0,0,0,0,0,0,0,0,0,0,0,0,0,0,0,0,0,0,0
Tritons,0,0,0,0,0,0,0,0,0,0,0,0,0,0,0,0,0,0,0,0,0,0,0,0
Miners,0,1,0,0,0,1,0,0,0,0,0,0,0,0,0,0,0,0,0,0,0,0,0,0
Flyers,0,0,0,0,0,0,0,0,0,0,0,0,0,0,0,0,0,0,0,0,0,0,0,0
Cardinals,0,0,0,0,0,0,0,0,0,0,0,0,0,0,0,0,0,0,0,0,0,0,0,0
Rangers,0,0,0,0,0,0,0,0,0,0,0,0,0,0,0,0,0,0,0,0,0,0,0,0
Bulldogs,0,0,0,0,0,0,0,0,0,0,0,0,0,0,0,0,0,0,0,0,0,0,0,0
Hawks,0,0,0,0,0,0,0,0,0,0,0,0,0,0,0,0,0,0,0,0,0,0,0,0
Greyhounds,0,0,0,0,0,0,0,0,0,0,0,0,0,0,0,0,0,0,0,0,0,0,0,0
Hawks,0,0,0,0,0,0,0,0,0,0,0,0,0,0,0,0,0,0,0,0,0,0,0,0
Saints,0,0,0,0,0,0,0,0,0,0,0,0,0,0,0,0,0,0,0,0,0,0,0,0
Bears,0,0,0,0,0,0,0,0,0,0,0,0,0,0,0,0,0,0,0,0,0,0,0,0
Tusculum,0,2,0,0,0,2,0,0,0,0,0,0,0,0,0,0,0,0,0,0,0,0,0,0
Lions,0,0,0,0,0,0,0,0,0,0,0,0,0,0,0,0,0,0,0,0,0,0,0,0
Bulldogs,0,0,0,0,0,0,0,0,0,0,0,0,0,0,0,0,0,0,0,0,0,0,0,0
Railsplitters,0,0,0,0,0,0,0,0,0,0,0,0,0,0,0,0,0,0,0,0,0,0,0,0
Coker,0,0,0,0,0,0,0,0,0,0,0,0,0,0,0,0,0,0,0,0,0,0,0,0
Wolves,0,2,0,0,0,2,0,0,0,0,0,0,0,0,0,0,0,0,0,0,0,0,0,0
Eagles,0,0,0,0,0,0,0,0,0,0,0,0,0,0,0,0,0,0,0,0,0,0,0,0
Indians,0,0,0,0,0,0,0,0,0,0,0,0,0,0,0,0,0,0,0,0,0,0,0,0
Tornados,0,1,0,0,0,1,0,0,0,0,0,0,0,0,0,0,0,0,0,0,0,0,0,0
Trojans,0,0,0,0,0,0,0,0,0,0,0,0,0,0,0,0,0,0,0,0,0,0,0,0
Tigers,0,0,0,0,0,0,0,0,0,0,0,0,0,0,0,0,0,0,0,0,0,0,0,0
Lopers,0,0,0,0,0,0,0,0,0,0,0,0,0,0,0,0,0,0,0,0,0,0,0,0
Lions,0,1,0,0,0,1,0,0,0,0,0,0,0,0,0,0,0,0,0,0,0,0,0,0
Bearcats,0,0,0,0,0,0,0,0,0,0,0,0,0,0,0,0,0,0,0,0,0,0,0,0
Mules,0,0,0,0,0,0,0,0,0,0,0,0,0,0,0,0,0,0,0,0,0,0,0,0
Washburn,0,0,0,0,0,0,0,0,0,0,0,0,0,0,0,0,0,0,0,0,0,0,0,0
Bearcats,0,0,0,0,0,0,0,0,0,0,0,0,0,0,0,0,0,0,0,0,0,0,0,0
Gorillas,0,0,0,0,0,0,0,0,0,0,0,0,0,0,0,0,0,0,0,0,0,0,0,0
Griffons,0,0,0,0,0,0,0,0,0,0,0,0,0,0,0,0,0,0,0,0,0,0,0,0
Bronchos,0,0,0,0,0,0,0,0,0,0,0,0,0,0,0,0,0,0,0,0,0,0,0,0
Riverhawks,0,1,0,0,0,1,0,0,0,0,0,0,0,0,0,0,0,0,0,0,0,0,0,0
Hornets,0,0,0,0,0,0,0,0,0,0,0,0,0,0,0,0,0,0,0,0,0,0,0,0
Golden Tigers,0,0,0,0,0,0,0,0,0,0,0,0,0,0,0,0,0,0,0,0,0,0,0,0
Golden Rams,0,0,0,0,0,0,0,0,0,0,0,0,0,0,0,0,0,0,0,0,0,0,0,0
Wildcats,0,1,0,0,0,1,0,0,0,0,0,0,0,0,0,0,0,0,0,0,0,0,0,0
Magicians,0,0,0,0,0,0,0,0,0,0,0,0,0,0,0,0,0,0,0,0,0,0,0,0
Tigers,0,0,0,0,0,0,0,0,0,0,0,0,0,0,0,0,0,0,0,0,0,0,0,0
Maroon Tigers,1,0,0,0,1,0,0,0,0,0,0,0,0,0,0,0,0,0,0,0,0,0,0,0
Panthers,0,0,0,0,0,0,0,0,0,0,0,0,0,0,0,0,0,0,0,0,0,0,0,0
Dragons,0,1,0,0,0,1,0,0,0,0,0,0,0,0,0,0,0,0,0,0,0,0,0,0
Badgers,0,1,0,0,0,1,0,0,0,0,0,0,0,0,0,0,0,0,0,0,0,0,0,0
Panthers,0,0,0,0,0,0,0,0,0,0,0,0,0,0,0,0,0,0,0,0,0,0,0,0
Golden Bears,0,0,0,0,0,0,0,0,0,0,0,0,0,0,0,0,0,0,0,0,0,0,0,0
Lions,0,0,0,0,0,0,0,0,0,0,0,0,0,0,0,0,0,0,0,0,0,0,0,0
Dragons,0,0,0,0,0,0,0,0,0,0,0,0,0,0,0,0,0,0,0,0,0,0,0,0
Bulldogs,0,0,0,0,0,0,0,0,0,0,0,0,0,0,0,0,0,0,0,0,0,0,0,0
Huskies,0,0,0,0,0,0,0,0,0,0,0,0,0,0,0,0,0,0,0,0,0,0,0,0
Golden Bears,0,1,0,0,0,1,0,0,0,0,0,0,0,0,0,0,0,0,0,0,0,0,0,0
Peacocks,0,0,0,0,0,0,0,0,0,0,0,0,0,0,0,0,0,0,0,0,0,0,0,0
Cougars,0,0,0,0,0,0,0,0,0,0,0,0,0,0,0,0,0,0,0,0,0,0,0,0
Wildcats,0,0,0,0,0,0,0,0,0,0,0,0,0,0,0,0,0,0,0,0,0,0,0,0
Beavers,0,0,0,0,0,0,0,0,0,0,0,0,0,0,0,0,0,0,0,0,0,0,0,0
Mustangs,0,0,0,0,0,0,0,0,0,0,0,0,0,0,0,0,0,0,0,0,0,0,0,0
Mavericks,0,0,0,0,0,0,0,0,0,0,0,0,0,0,0,0,0,0,0,0,0,0,0,0
Vikings,0,0,0,0,0,0,0,0,0,0,0,0,0,0,0,0,0,0,0,0,0,0,0,0
Wolves,0,0,0,0,0,0,0,0,0,0,0,0,0,0,0,0,0,0,0,0,0,0,0,0
Marauders,0,0,0,0,0,0,0,0,0,0,0,0,0,0,0,0,0,0,0,0,0,0,0,0
Beavers,0,0,0,0,0,0,0,0,0,0,0,0,0,0,0,0,0,0,0,0,0,0,0,0
Golden Eagles,0,1,0,0,0,1,0,0,0,0,0,0,0,0,0,0,0,0,0,0,0,0,0,0
Warriors,0,0,0,0,0,0,0,0,0,0,0,0,0,0,0,0,0,0,0,0,0,0,0,0
Timberwolves,0,0,0,0,0,0,0,0,0,0,0,0,0,0,0,0,0,0,0,0,0,0,0,0
Panthers,0,0,0,0,0,0,0,0,0,0,0,0,0,0,0,0,0,0,0,0,0,0,0,0
Storm,0,0,0,0,0,0,0,0,0,0,0,0,0,0,0,0,0,0,0,0,0,0,0,0
Cavaliers,0,0,0,0,0,0,0,0,0,0,0,0,0,0,0,0,0,0,0,0,0,0,0,0
Huskies,1,0,0,0,1,0,0,0,0,0,0,0,0,0,0,0,0,0,0,0,0,0,0,0
Wildcats,0,0,0,0,0,0,0,0,0,0,0,0,0,0,0,0,0,0,0,0,0,0,0,0
Lakers,0,0,0,0,0,0,0,0,0,0,0,0,0,0,0,0,0,0,0,0,0,0,0,0
Chargers,0,0,0,0,0,0,0,0,0,0,0,0,0,0,0,0,0,0,0,0,0,0,0,0
Lakers,0,0,0,0,0,0,0,0,0,0,0,0,0,0,0,0,0,0,0,0,0,0,0,0
Oilers,0,0,0,0,0,0,0,0,0,0,0,0,0,0,0,0,0,0,0,0,0,0,0,0
Pioneers,0,0,0,0,0,0,0,0,0,0,0,0,0,0,0,0,0,0,0,0,0,0,0,0
Eagles,0,0,0,0,0,0,0,0,0,0,0,0,0,0,0,0,0,0,0,0,0,0,0,0
Bulldogs,0,0,0,0,0,0,0,0,0,0,0,0,0,0,0,0,0,0,0,0,0,0,0,0
Warriors,0,0,0,0,0,0,0,0,0,0,0,0,0,0,0,0,0,0,0,0,0,0,0,0
Dragons,0,0,0,0,0,0,0,0,0,0,0,0,0,0,0,0,0,0,0,0,0,0,0,0
Cardinals,0,0,0,0,0,0,0,0,0,0,0,0,0,0,0,0,0,0,0,0,0,0,0,0
Rangers,0,0,0,0,0,0,0,0,0,0,0,0,0,0,0,0,0,0,0,0,0,0,0,0
Wonder Boys,0,0,0,0,0,0,0,0,0,0,0,0,0,0,0,0,0,0,0,0,0,0,0,0
Bison,0,0,0,0,0,0,0,0,0,0,0,0,0,0,0,0,0,0,0,0,0,0,0,0
Boll Weevils,0,0,0,0,0,0,0,0,0,0,0,0,0,0,0,0,0,0,0,0,0,0,0,0
Tigers,0,1,0,0,0,1,0,0,0,0,0,0,0,0,0,0,0,0,0,0,0,0,0,0
Bulldogs,0,0,0,0,0,0,0,0,0,0,0,0,0,0,0,0,0,0,0,0,0,0,0,0
Muleriders,0,0,0,0,0,0,0,0,0,0,0,0,0,0,0,0,0,0,0,0,0,0,0,0
Tigers,0,0,0,0,0,0,0,0,0,0,0,0,0,0,0,0,0,0,0,0,0,0,0,0
Bison,0,0,0,0,0,0,0,0,0,0,0,0,0,0,0,0,0,0,0,0,0,0,0,0
Savage Storm,0,0,0,0,0,0,0,0,0,0,0,0,0,0,0,0,0,0,0,0,0,0,0,0
Crimson Storm,0,0,0,0,0,0,0,0,0,0,0,0,0,0,0,0,0,0,0,0,0,0,0,0
Reddies,0,0,0,0,0,0,0,0,0,0,0,0,0,0,0,0,0,0,0,0,0,0,0,0
Spartans,0,0,0,0,0,0,0,0,0,0,0,0,0,0,0,0,0,0,0,0,0,0,0,0
Redhawks,0,0,0,0,0,0,0,0,0,0,0,0,0,0,0,0,0,0,0,0,0,0,0,0
Lions,0,0,0,0,0,0,0,0,0,0,0,0,0,0,0,0,0,0,0,0,0,0,0,0
Golden Lions,0,0,0,0,0,0,0,0,0,0,0,0,0,0,0,0,0,0,0,0,0,0,0,0
Mavericks,0,1,0,0,0,1,0,0,0,0,0,0,0,0,0,0,0,0,0,0,0,0,0,0
Wildcats,0,0,0,0,0,0,0,0,0,0,0,0,0,0,0,0,0,0,0,0,0,0,0,0
Firebirds,0,1,0,0,0,1,0,0,0,0,0,0,0,0,0,0,0,0,0,0,0,0,0,0
Purple Knights,0,0,0,0,0,0,0,0,0,0,0,0,0,0,0,0,0,0,0,0,0,0,0,0
Knights,0,0,0,0,0,0,0,0,0,0,0,0,0,0,0,0,0,0,0,0,0,0,0,0
Bears,0,0,0,0,0,0,0,0,0,0,0,0,0,0,0,0,0,0,0,0,0,0,0,0
Crusaders,0,0,0,0,0,0,0,0,0,0,0,0,0,0,0,0,0,0,0,0,0,0,0,0
Yellowjackets,0,0,0,0,0,0,0,0,0,0,0,0,0,0,0,0,0,0,0,0,0,0,0,0
Vikings,0,0,0,0,0,0,0,0,0,0,0,0,0,0,0,0,0,0,0,0,0,0,0,0
Falcons,0,1,0,0,0,1,0,0,0,0,0,0,0,0,0,0,0,0,0,0,0,0,0,0
Clan,0,0,0,0,0,0,0,0,0,0,0,0,0,0,0,0,0,0,0,0,0,0,0,0
Nanooks,0,0,0,0,0,0,0,0,0,0,0,0,0,0,0,0,0,0,0,0,0,0,0,0
Wildcats,0,0,0,0,0,0,0,0,0,0,0,0,0,0,0,0,0,0,0,0,0,0,0,0
Seawolves,0,0,0,0,0,0,0,0,0,0,0,0,0,0,0,0,0,0,0,0,0,0,0,0
Saints,0,0,0,0,0,0,0,0,0,0,0,0,0,0,0,0,0,0,0,0,0,0,0,0
Rams,0,0,0,0,0,0,0,0,0,0,0,0,0,0,0,0,0,0,0,0,0,0,0,0
Aggies,0,0,0,0,0,0,0,0,0,0,0,0,0,0,0,0,0,0,0,0,0,0,0,0
Mustangs,0,0,0,0,0,0,0,0,0,0,0,0,0,0,0,0,0,0,0,0,0,0,0,0
Buffalos,0,0,0,0,0,0,0,0,0,0,0,0,0,0,0,0,0,0,0,0,0,0,0,0
Greyhounds,0,0,0,0,0,0,0,0,0,0,0,0,0,0,0,0,0,0,0,0,0,0,0,0
Javelinas,0,1,0,0,0,1,0,0,0,0,0,0,0,0,0,0,0,0,0,0,0,0,0,0
Eagles,0,0,0,0,0,0,0,0,0,0,0,0,0,0,0,0,0,0,0,0,0,0,0,0
Aggies,0,0,0,0,0,0,0,0,0,0,0,0,0,0,0,0,0,0,0,0,0,0,0,0
Hilltoppers,0,0,0,0,0,0,0,0,0,0,0,0,0,0,0,0,0,0,0,0,0,0,0,0
Hillcats,1,0,0,0,1,0,0,0,0,0,0,0,0,0,0,0,0,0,0,0,0,0,0,0
UTPB,0,1,0,0,0,1,0,0,0,0,0,0,0,0,0,0,0,0,0,0,0,0,0,0
Texas A&M Intl,0,0,0,0,0,0,0,0,0,0,0,0,0,0,0,0,0,0,0,0,0,0,0,0
Patriots,0,0,0,0,0,0,0,0,0,0,0,0,0,0,0,0,0,0,0,0,0,0,0,0
Jets,0,0,0,0,0,0,0,0,0,0,0,0,0,0,0,0,0,0,0,0,0,0,0,0
Rattlers,0,0,0,0,0,0,0,0,0,0,0,0,0,0,0,0,0,0,0,0,0,0,0,0
Lions,0,0,0,0,0,0,0,0,0,0,0,0,0,0,0,0,0,0,0,0,0,0,0,0
Chaparral,0,0,0,0,0,0,0,0,0,0,0,0,0,0,0,0,0,0,0,0,0,0,0,0
Tritons,0,0,0,0,0,0,0,0,0,0,0,0,0,0,0,0,0,0,0,0,0,0,0,0
Buccaneers,0,0,0,0,0,0,0,0,0,0,0,0,0,0,0,0,0,0,0,0,0,0,0,0
Sharks,0,0,0,0,0,0,0,0,0,0,0,0,0,0,0,0,0,0,0,0,0,0,0,0
Tars,0,0,0,0,0,0,0,0,0,0,0,0,0,0,0,0,0,0,0,0,0,0,0,0
Fighting Knights,0,0,0,0,0,0,0,0,0,0,0,0,0,0,0,0,0,0,0,0,0,0,0,0
Eagles,0,0,0,0,0,0,0,0,0,0,0,0,0,0,0,0,0,0,0,0,0,0,0,0
Lions,0,0,0,0,0,0,0,0,0,0,0,0,0,0,0,0,0,0,0,0,0,0,0,0
Sailfish,0,0,0,0,0,0,0,0,0,0,0,0,0,0,0,0,0,0,0,0,0,0,0,0
Mocs,0,0,0,0,0,0,0,0,0,0,0,0,0,0,0,0,0,0,0,0,0,0,0,0
Spartans,0,0,0,0,0,0,0,0,0,0,0,0,0,0,0,0,0,0,0,0,0,0,0,0
Fighting Owls,0,0,0,0,0,0,0,0,0,0,0,0,0,0,0,0,0,0,0,0,0,0,0,0
Falcons,0,0,0,0,0,0,0,0,0,0,0,0,0,0,0,0,0,0,0,0,0,0,0,0
Chargers,0,0,0,0,0,0,0,0,0,0,0,0,0,0,0,0,0,0,0,0,0,0,0,0
Panthers,0,0,0,0,0,0,0,0,0,0,0,0,0,0,0,0,0,0,0,0,0,0,0,0
Purple Knights,0,0,0,0,0,0,0,0,0,0,0,0,0,0,0,0,0,0,0,0,0,0,0,0
Ravens,0,1,0,0,0,1,0,0,0,0,0,0,0,0,0,0,0,0,0,0,0,0,0,0
Golden Knights,0,0,0,0,0,0,0,0,0,0,0,0,0,0,0,0,0,0,0,0,0,0,0,0
Penmen,0,0,0,0,0,0,0,0,0,0,0,0,0,0,0,0,0,0,0,0,0,0,0,0
Hawks,0,0,0,0,0,0,0,0,0,0,0,0,0,0,0,0,0,0,0,0,0,0,0,0
Yellow Jackets,0,0,0,0,0,0,0,0,0,0,0,0,0,0,0,0,0,0,0,0,0,0,0,0
Setters,0,0,0,0,0,0,0,0,0,0,0,0,0,0,0,0,0,0,0,0,0,0,0,0
Greyhounds,0,0,0,0,0,0,0,0,0,0,0,0,0,0,0,0,0,0,0,0,0,0,0,0
Lightning,0,0,0,0,0,0,0,0,0,0,0,0,0,0,0,0,0,0,0,0,0,0,0,0
Devils,0,0,0,0,0,0,0,0,0,0,0,0,0,0,0,0,0,0,0,0,0,0,0,0
Tigers,0,1,0,0,0,1,0,0,0,0,0,0,0,0,0,0,0,0,0,0,0,0,0,0
Rams,0,0,0,0,0,0,0,0,0,0,0,0,0,0,0,0,0,0,0,0,0,0,0,0
Cougars,0,0,0,0,0,0,0,0,0,0,0,0,0,0,0,0,0,0,0,0,0,0,0,0
Chargers,0,0,0,0,0,0,0,0,0,0,0,0,0,0,0,0,0,0,0,0,0,0,0,0
Clippers,0,0,0,0,0,0,0,0,0,0,0,0,0,0,0,0,0,0,0,0,0,0,0,0
Warriors,0,0,0,0,0,0,0,0,0,0,0,0,0,0,0,0,0,0,0,0,0,0,0,0
Bears,0,0,0,0,0,0,0,0,0,0,0,0,0,0,0,0,0,0,0,0,0,0,0,0
Golden Falcons,0,0,0,0,0,0,0,0,0,0,0,0,0,0,0,0,0,0,0,0,0,0,0,0
Wildcats,0,0,0,0,0,0,0,0,0,0,0,0,0,0,0,0,0,0,0,0,0,0,0,0
Lions,0,2,0,0,0,2,0,0,0,0,0,0,0,0,0,0,0,0,0,0,0,0,0,0
Griffins,0,1,0,0,0,1,0,0,0,0,0,0,0,0,0,0,0,0,0,0,0,0,0,0
Eagles,0,0,0,0,0,0,0,0,0,0,0,0,0,0,0,0,0,0,0,0,0,0,0,0
Mountain Lions,0,0,0,0,0,0,0,0,0,0,0,0,0,0,0,0,0,0,0,0,0,0,0,0
Rams,0,0,0,0,0,0,0,0,0,0,0,0,0,0,0,0,0,0,0,0,0,0,0,0
Yellow Jackets,0,0,0,0,0,0,0,0,0,0,0,0,0,0,0,0,0,0,0,0,0,0,0,0
Fighting Falcons,0,0,0,0,0,0,0,0,0,0,0,0,0,0,0,0,0,0,0,0,0,0,0,0
Cardinals,0,0,0,0,0,0,0,0,0,0,0,0,0,0,0,0,0,0,0,0,0,0,0,0
Bobcats,0,1,0,0,0,1,0,0,0,0,0,0,0,0,0,0,0,0,0,0,0,0,0,0
Falcons,0,0,0,0,0,0,0,0,0,0,0,0,0,0,0,0,0,0,0,0,0,0,0,0
Golden Eagles,0,0,0,0,0,0,0,0,0,0,0,0,0,0,0,0,0,0,0,0,0,0,0,0
Hilltoppers,0,0,0,0,0,0,0,0,0,0,0,0,0,0,0,0,0,0,0,0,0,0,0,0
Blue Knights,0,0,0,0,0,0,0,0,0,0,0,0,0,0,0,0,0,0,0,0,0,0,0,0
Highland Cavaliers,0,1,0,0,0,1,0,0,0,0,0,0,0,0,0,0,0,0,0,0,0,0,0,0
Pioneers,0,0,0,0,0,0,0,0,0,0,0,0,0,0,0,0,0,0,0,0,0,0,0,0
Thunderwolves,0,0,0,0,0,0,0,0,0,0,0,0,0,0,0,0,0,0,0,0,0,0,0,0
Skyhawks,0,0,0,0,0,0,0,0,0,0,0,0,0,0,0,0,0,0,0,0,0,0,0,0
Rangers,0,0,0,0,0,0,0,0,0,0,0,0,0,0,0,0,0,0,0,0,0,0,0,0
Roadrunners,0,0,0,0,0,0,0,0,0,0,0,0,0,0,0,0,0,0,0,0,0,0,0,0
Hardrockers,0,1,0,0,0,1,0,0,0,0,0,0,0,0,0,0,0,0,0,0,0,0,0,0
Mavericks,0,0,0,0,0,0,0,0,0,0,0,0,0,0,0,0,0,0,0,0,0,0,0,0
Orediggers,0,0,0,0,0,0,0,0,0,0,0,0,0,0,0,0,0,0,0,0,0,0,0,0
Cowboys,0,1,0,0,0,1,0,0,0,0,0,0,0,0,0,0,0,0,0,0,0,0,0,0
Yellow Jackets,0,0,0,0,0,0,0,0,0,0,0,0,0,0,0,0,0,0,0,0,0,0,0,0
Eagles,0,1,0,0,0,1,0,0,0,0,0,0,0,0,0,0,0,0,0,0,0,0,0,0
Adams State,0,0,0,0,0,0,0,0,0,0,0,0,0,0,0,0,0,0,0,0,0,0,0,0
Mountaineers,0,2,0,0,0,2,0,0,0,0,0,0,0,0,0,0,0,0,0,0,0,0,0,0
Mountain Lions,0,1,0,0,0,1,0,0,0,0,0,0,0,0,0,0,0,0,0,0,0,0,0,0
Mighty Oaks,0,0,0,0,0,0,0,0,0,0,0,0,0,0,0,0,0,0,0,0,0,0,0,0
Blues,0,0,0,0,0,0,0,0,0,0,0,0,0,0,0,0,0,0,0,0,0,0,0,0
Warriors,0,0,0,0,0,0,0,0,0,0,0,0,0,0,0,0,0,0,0,0,0,0,0,0
Raiders,0,0,0,0,0,0,0,0,0,0,0,0,0,0,0,0,0,0,0,0,0,0,0,0
Huskies,0,0,0,0,0,0,0,0,0,0,0,0,0,0,0,0,0,0,0,0,0,0,0,0
Golden Bears,0,0,0,0,0,0,0,0,0,0,0,0,0,0,0,0,0,0,0,0,0,0,0,0
Marauders,0,0,0,0,0,0,0,0,0,0,0,0,0,0,0,0,0,0,0,0,0,0,0,0
Crimson Hawks,0,0,0,0,0,0,0,0,0,0,0,0,0,0,0,0,0,0,0,0,0,0,0,0
Mountaineers,0,1,0,0,0,1,0,0,0,0,0,0,0,0,0,0,0,0,0,0,0,0,0,0
Golden Rams,0,0,0,0,0,0,0,0,0,0,0,0,0,0,0,0,0,0,0,0,0,0,0,0
Fighting Scots,0,0,0,0,0,0,0,0,0,0,0,0,0,0,0,0,0,0,0,0,0,0,0,0
Golden Eagles,0,0,0,0,0,0,0,0,0,0,0,0,0,0,0,0,0,0,0,0,0,0,0,0
Gannon,0,0,0,0,0,0,0,0,0,0,0,0,0,0,0,0,0,0,0,0,0,0,0,0
Bald Eagles,0,0,0,0,0,0,0,0,0,0,0,0,0,0,0,0,0,0,0,0,0,0,0,0
Nittany Lions,0,0,0,0,0,0,0,0,0,0,0,0,0,0,0,0,0,0,0,0,0,0,0,0
Griffins,0,0,0,0,0,0,0,0,0,0,0,0,0,0,0,0,0,0,0,0,0,0,0,0
Mountain Cats,0,0,0,0,0,0,0,0,0,0,0,0,0,0,0,0,0,0,0,0,0,0,0,0
The Rock,0,0,0,0,0,0,0,0,0,0,0,0,0,0,0,0,0,0,0,0,0,0,0,0
Vulcans,0,0,0,0,0,0,0,0,0,0,0,0,0,0,0,0,0,0,0,0,0,0,0,0
Saints,0,0,0,0,0,0,0,0,0,0,0,0,0,0,0,0,0,0,0,0,0,0,0,0
Braves,0,0,0,0,0,0,0,0,0,0,0,0,0,0,0,0,0,0,0,0,0,0,0,0
Bobcats,0,0,0,0,0,0,0,0,0,0,0,0,0,0,0,0,0,0,0,0,0,0,0,0
Falcons,0,0,0,0,0,0,0,0,0,0,0,0,0,0,0,0,0,0,0,0,0,0,0,0
Patriots,0,0,0,0,0,0,0,0,0,0,0,0,0,0,0,0,0,0,0,0,0,0,0,0
Columbus State,0,0,0,0,0,0,0,0,0,0,0,0,0,0,0,0,0,0,0,0,0,0,0,0
Hurricanes,0,0,0,0,0,0,0,0,0,0,0,0,0,0,0,0,0,0,0,0,0,0,0,0
Mountain Lions,0,0,0,0,0,0,0,0,0,0,0,0,0,0,0,0,0,0,0,0,0,0,0,0
Pacers,0,0,0,0,0,0,0,0,0,0,0,0,0,0,0,0,0,0,0,0,0,0,0,0
Bearcats,0,0,0,0,0,0,0,0,0,0,0,0,0,0,0,0,0,0,0,0,0,0,0,0
Lakers,0,0,0,0,0,0,0,0,0,0,0,0,0,0,0,0,0,0,0,0,0,0,0,0
Jaguars,0,1,0,0,0,1,0,0,0,0,0,0,0,0,0,0,0,0,0,0,0,0,0,0
North Georgia,0,0,0,0,0,0,0,0,0,0,0,0,0,0,0,0,0,0,0,0,0,0,0,0
Hawks,0,0,0,0,0,0,0,0,0,0,0,0,0,0,0,0,0,0,0,0,0,0,0,0
Sunbirds,0,0,0,0,0,0,0,0,0,0,0,0,0,0,0,0,0,0,0,0,0,0,0,0
Cougars,0,0,0,0,0,0,0,0,0,0,0,0,0,0,0,0,0,0,0,0,0,0,0,0
Penguins,0,0,0,0,0,0,0,0,0,0,0,0,0,0,0,0,0,0,0,0,0,0,0,0
Vulcans,0,1,0,0,0,1,0,0,0,0,0,0,0,0,0,0,0,0,0,0,0,0,0,0
Sea Lions,0,0,0,0,0,0,0,0,0,0,0,0,0,0,0,0,0,0,0,0,0,0,0,0
Argonauts,0,0,0,0,0,0,0,0,0,0,0,0,0,0,0,0,0,0,0,0,0,0,0,0
Sharks,0,1,0,0,0,1,0,0,0,0,0,0,0,0,0,0,0,0,0,0,0,0,0,0
Silverswords,0,0,0,0,0,0,0,0,0,0,0,0,0,0,0,0,0,0,0,0,0,0,0,0
Urban Knights,0,0,0,0,0,0,0,0,0,0,0,0,0,0,0,0,0,0,0,0,0,0,0,0
Sabers,0,0,0,0,0,0,0,0,0,0,0,0,0,0,0,0,0,0,0,0,0,0,0,0
Bulldogs,0,0,0,0,0,0,0,0,0,0,0,0,0,0,0,0,0,0,0,0,0,0,0,0
Owls,0,0,0,0,0,0,0,0,0,0,0,0,0,0,0,0,0,0,0,0,0,0,0,0
Tigers,0,0,0,0,0,0,0,0,0,0,0,0,0,0,0,0,0,0,0,0,0,0,0,0
Knights,0,2,0,0,0,2,0,0,0,0,0,0,0,0,0,0,0,0,0,0,0,0,0,0
Lakers,0,0,0,0,0,0,0,0,0,0,0,0,0,0,0,0,0,0,0,0,0,0,0,0
Bears,0,0,0,0,0,0,0,0,0,0,0,0,0,0,0,0,0,0,0,0,0,0,0,0
Blue Angels,0,0,0,0,0,0,0,0,0,0,0,0,0,0,0,0,0,0,0,0,0,0,0,0
Rams,0,0,0,0,0,0,0,0,0,0,0,0,0,0,0,0,0,0,0,0,0,0,0,0
Cougars,0,0,0,0,0,0,0,0,0,0,0,0,0,0,0,0,0,0,0,0,0,0,0,0
Eagles,0,0,0,0,0,0,0,0,0,0,0,0,0,0,0,0,0,0,0,0,0,0,0,0
Shock,0,1,0,0,0,1,0,0,0,0,0,0,0,0,0,0,0,0,0,0,0,0,0,0
Warriors,0,0,0,0,0,0,0,0,0,0,0,0,0,0,0,0,0,0,0,0,0,0,0,0
Gladiators,0,0,0,0,0,0,0,0,0,0,0,0,0,0,0,0,0,0,0,0,0,0,0,0
Oakwood,0,2,0,0,0,2,0,0,0,0,0,0,0,0,0,0,0,0,0,0,0,0,0,0
Dragons,0,13,0,0,0,13,0,0,0,0,0,0,0,0,0,0,0,0,0,0,0,0,0,0
Nittany Lions,0,0,0,0,0,0,0,0,0,0,0,0,0,0,0,0,0,0,0,0,0,0,0,0
Florida College,0,0,0,0,0,0,0,0,0,0,0,0,0,0,0,0,0,0,0,0,0,0,0,0
Mustangs,0,4,0,0,0,4,0,0,0,0,0,0,0,0,0,0,0,0,0,0,0,0,0,0
Crusaders,0,0,0,0,0,0,0,0,0,0,0,0,0,0,0,0,0,0,0,0,0,0,0,0
Nittany Lions,0,0,0,0,0,0,0,0,0,0,0,0,0,0,0,0,0,0,0,0,0,0,0,0
Hornets,0,0,0,0,0,0,0,0,0,0,0,0,0,0,0,0,0,0,0,0,0,0,0,0
Owls,0,0,0,0,0,0,0,0,0,0,0,0,0,0,0,0,0,0,0,0,0,0,0,0
Florida National,0,1,0,0,0,1,0,0,0,0,0,0,0,0,0,0,0,0,0,0,0,0,0,0
Bengals,0,1,0,0,0,1,0,0,0,0,0,0,0,0,0,0,0,0,0,0,0,0,0,0
Phantoms,0,5,0,0,0,5,0,0,0,0,0,0,0,0,0,0,0,0,0,0,0,0,0,0
Knights,0,2,0,0,0,2,0,0,0,0,0,0,0,0,0,0,0,0,0,0,0,0,0,0
Bulldogs,0,1,0,0,0,1,0,0,0,0,0,0,0,0,0,0,0,0,0,0,0,0,0,0
Wildcats,0,0,0,0,0,0,0,0,0,0,0,0,0,0,0,0,0,0,0,0,0,0,0,0
Crusaders,0,1,0,0,0,1,0,0,0,0,0,0,0,0,0,0,0,0,0,0,0,0,0,0
Clippers,0,0,0,0,0,0,0,0,0,0,0,0,0,0,0,0,0,0,0,0,0,0,0,0
Bears,0,0,0,0,0,0,0,0,0,0,0,0,0,0,0,0,0,0,0,0,0,0,0,0
Shoremen,0,2,0,0,0,2,0,0,0,0,0,0,0,0,0,0,0,0,0,0,0,0,0,0
Fords,0,0,0,0,0,0,0,0,0,0,0,0,0,0,0,0,0,0,0,0,0,0,0,0
Mariners,0,1,0,0,0,1,0,0,0,0,0,0,0,0,0,0,0,0,0,0,0,0,0,0
Greyhounds,0,0,0,0,0,0,0,0,0,0,0,0,0,0,0,0,0,0,0,0,0,0,0,0
Cardinals,0,0,0,0,0,0,0,0,0,0,0,0,0,0,0,0,0,0,0,0,0,0,0,0
Gophers,0,0,0,0,0,0,0,0,0,0,0,0,0,0,0,0,0,0,0,0,0,0,0,0
Crusaders,0,0,0,0,0,0,0,0,0,0,0,0,0,0,0,0,0,0,0,0,0,0,0,0
Eagles,0,0,0,0,0,0,0,0,0,0,0,0,0,0,0,0,0,0,0,0,0,0,0,0
Ravens,0,1,0,0,0,1,0,0,0,0,0,0,0,0,0,0,0,0,0,0,0,0,0,0
Quakers,0,1,0,0,0,1,0,0,0,0,0,0,0,0,0,0,0,0,0,0,0,0,0,0
Yellow Jackets,0,4,0,0,0,4,0,0,0,0,0,0,0,0,0,0,0,0,0,0,0,0,0,0
Pioneers,0,0,0,0,0,0,0,0,0,0,0,0,0,0,0,0,0,0,0,0,0,0,0,0
Spartans,0,0,0,0,0,0,0,0,0,0,0,0,0,0,0,0,0,0,0,0,0,0,0,0
Lions,0,0,0,0,0,0,0,0,0,0,0,0,0,0,0,0,0,0,0,0,0,0,0,0
Beavers,0,1,0,0,0,1,0,0,0,0,0,0,0,0,0,0,0,0,0,0,0,0,0,0
Devils,0,0,0,0,0,0,0,0,0,0,0,0,0,0,0,0,0,0,0,0,0,0,0,0
Nighthawks,0,0,0,0,0,0,0,0,0,0,0,0,0,0,0,0,0,0,0,0,0,0,0,0
Fighting Scots,0,0,0,0,0,0,0,0,0,0,0,0,0,0,0,0,0,0,0,0,0,0,0,0
Knights,0,1,0,0,0,1,0,0,0,0,0,0,0,0,0,0,0,0,0,0,0,0,0,0
Lancers,0,0,0,0,0,0,0,0,0,0,0,0,0,0,0,0,0,0,0,0,0,0,0,0
Griffins,0,1,0,0,0,1,0,0,0,0,0,0,0,0,0,0,0,0,0,0,0,0,0,0
Defenders,0,0,0,0,0,0,0,0,0,0,0,0,0,0,0,0,0,0,0,0,0,0,0,0
Giants,0,0,0,0,0,0,0,0,0,0,0,0,0,0,0,0,0,0,0,0,0,0,0,0
Mighty Macs,0,1,0,0,0,1,0,0,0,0,0,0,0,0,0,0,0,0,0,0,0,0,0,0
Pacers,0,1,0,0,0,1,0,0,0,0,0,0,0,0,0,0,0,0,0,0,0,0,0,0
Cavaliers,0,0,0,0,0,0,0,0,0,0,0,0,0,0,0,0,0,0,0,0,0,0,0,0
Cyclones,0,0,0,0,0,0,0,0,0,0,0,0,0,0,0,0,0,0,0,0,0,0,0,0
Blazers,0,0,0,0,0,0,0,0,0,0,0,0,0,0,0,0,0,0,0,0,0,0,0,0
Eagles,0,0,0,0,0,0,0,0,0,0,0,0,0,0,0,0,0,0,0,0,0,0,0,0
Pride,0,0,0,0,0,0,0,0,0,0,0,0,0,0,0,0,0,0,0,0,0,0,0,0
Knights,0,0,0,0,0,0,0,0,0,0,0,0,0,0,0,0,0,0,0,0,0,0,0,0
Flying Dutchmen,0,0,0,0,0,0,0,0,0,0,0,0,0,0,0,0,0,0,0,0,0,0,0,0
Falcons,0,0,0,0,0,0,0,0,0,0,0,0,0,0,0,0,0,0,0,0,0,0,0,0
Valiants,0,1,0,0,0,1,0,0,0,0,0,0,0,0,0,0,0,0,0,0,0,0,0,0
Stormy Petrels,0,2,0,0,0,2,0,0,0,0,0,0,0,0,0,0,0,0,0,0,0,0,0,0
Vikings,0,0,0,0,0,0,0,0,0,0,0,0,0,0,0,0,0,0,0,0,0,0,0,0
Warriors,0,0,0,0,0,0,0,0,0,0,0,0,0,0,0,0,0,0,0,0,0,0,0,0
Tigers,0,0,0,0,0,0,0,0,0,0,0,0,0,0,0,0,0,0,0,0,0,0,0,0
Majors,0,0,0,0,0,0,0,0,0,0,0,0,0,0,0,0,0,0,0,0,0,0,0,0
Lynx,0,2,0,0,0,2,0,0,0,0,0,0,0,0,0,0,0,0,0,0,0,0,0,0
Fighting Quakers,0,0,0,0,0,0,0,0,0,0,0,0,0,0,0,0,0,0,0,0,0,0,0,0
Fighting Muskies,0,1,0,0,0,1,0,0,0,0,0,0,0,0,0,0,0,0,0,0,0,0,0,0
Crusaders,0,1,0,0,0,1,0,0,0,0,0,0,0,0,0,0,0,0,0,0,0,0,0,0
Polar Bears,0,0,0,0,0,0,0,0,0,0,0,0,0,0,0,0,0,0,0,0,0,0,0,0
Student Princes,0,1,0,0,0,1,0,0,0,0,0,0,0,0,0,0,0,0,0,0,0,0,0,0
Big Red,0,0,0,0,0,0,0,0,0,0,0,0,0,0,0,0,0,0,0,0,0,0,0,0
Little Giants,0,0,0,0,0,0,0,0,0,0,0,0,0,0,0,0,0,0,0,0,0,0,0,0
Terriers,0,0,0,0,0,0,0,0,0,0,0,0,0,0,0,0,0,0,0,0,0,0,0,0
Tigers,0,0,0,0,0,0,0,0,0,0,0,0,0,0,0,0,0,0,0,0,0,0,0,0
Yeomen,0,0,0,0,0,0,0,0,0,0,0,0,0,0,0,0,0,0,0,0,0,0,0,0
Lords,0,0,0,0,0,0,0,0,0,0,0,0,0,0,0,0,0,0,0,0,0,0,0,0
Panthers,0,1,0,0,0,1,0,0,0,0,0,0,0,0,0,0,0,0,0,0,0,0,0,0
Rams,0,0,0,0,0,0,0,0,0,0,0,0,0,0,0,0,0,0,0,0,0,0,0,0
Privateers,0,1,0,0,0,1,0,0,0,0,0,0,0,0,0,0,0,0,0,0,0,0,0,0
Dolphins,0,0,0,0,0,0,0,0,0,0,0,0,0,0,0,0,0,0,0,0,0,0,0,0
Gryphons,0,1,0,0,0,1,0,0,0,0,0,0,0,0,0,0,0,0,0,0,0,0,0,0
Cougars,0,1,0,0,0,1,0,0,0,0,0,0,0,0,0,0,0,0,0,0,0,0,0,0
Bearcats,0,0,0,0,0,0,0,0,0,0,0,0,0,0,0,0,0,0,0,0,0,0,0,0
Bloodhounds,0,1,0,0,0,1,0,0,0,0,0,0,0,0,0,0,0,0,0,0,0,0,0,0
Beavers,0,0,0,0,0,0,0,0,0,0,0,0,0,0,0,0,0,0,0,0,0,0,0,0
Dolphins,0,0,0,0,0,0,0,0,0,0,0,0,0,0,0,0,0,0,0,0,0,0,0,0
Britons,0,0,0,0,0,0,0,0,0,0,0,0,0,0,0,0,0,0,0,0,0,0,0,0
Hornets,0,0,0,0,0,0,0,0,0,0,0,0,0,0,0,0,0,0,0,0,0,0,0,0
Comets,0,0,0,0,0,0,0,0,0,0,0,0,0,0,0,0,0,0,0,0,0,0,0,0
Bulldogs,0,0,0,0,0,0,0,0,0,0,0,0,0,0,0,0,0,0,0,0,0,0,0,0
Scots,0,0,0,0,0,0,0,0,0,0,0,0,0,0,0,0,0,0,0,0,0,0,0,0
Spartans,0,0,0,0,0,0,0,0,0,0,0,0,0,0,0,0,0,0,0,0,0,0,0,0
Eagles,0,0,0,0,0,0,0,0,0,0,0,0,0,0,0,0,0,0,0,0,0,0,0,0
Colonels,0,0,0,0,0,0,0,0,0,0,0,0,0,0,0,0,0,0,0,0,0,0,0,0
Golden Bears,0,0,0,0,0,0,0,0,0,0,0,0,0,0,0,0,0,0,0,0,0,0,0,0
Seahawks,0,0,0,0,0,0,0,0,0,0,0,0,0,0,0,0,0,0,0,0,0,0,0,0
Bison,0,0,0,0,0,0,0,0,0,0,0,0,0,0,0,0,0,0,0,0,0,0,0,0
Leopards,0,0,0,0,0,0,0,0,0,0,0,0,0,0,0,0,0,0,0,0,0,0,0,0
Cougars,0,0,0,0,0,0,0,0,0,0,0,0,0,0,0,0,0,0,0,0,0,0,0,0
Yellowjackets,0,0,0,0,0,0,0,0,0,0,0,0,0,0,0,0,0,0,0,0,0,0,0,0
Storm,0,1,0,0,0,1,0,0,0,0,0,0,0,0,0,0,0,0,0,0,0,0,0,0
LumberJacks,0,0,0,0,0,0,0,0,0,0,0,0,0,0,0,0,0,0,0,0,0,0,0,0
Eagles,0,0,0,0,0,0,0,0,0,0,0,0,0,0,0,0,0,0,0,0,0,0,0,0
Lobos,0,1,0,0,0,1,0,0,0,0,0,0,0,0,0,0,0,0,0,0,0,0,0,0
LeTourneau,0,2,0,0,0,2,0,0,0,0,0,0,0,0,0,0,0,0,0,0,0,0,0,0
Tigers,0,0,0,0,0,0,0,0,0,0,0,0,0,0,0,0,0,0,0,0,0,0,0,0
War Hawks,0,2,0,0,0,2,0,0,0,0,0,0,0,0,0,0,0,0,0,0,0,0,0,0
Cowboys,0,1,0,0,0,1,0,0,0,0,0,0,0,0,0,0,0,0,0,0,0,0,0,0
Yellow Jackets,0,2,0,0,0,2,0,0,0,0,0,0,0,0,0,0,0,0,0,0,0,0,0,0
Patriots,0,0,0,0,0,0,0,0,0,0,0,0,0,0,0,0,0,0,0,0,0,0,0,0
Wildcats,0,1,0,0,0,1,0,0,0,0,0,0,0,0,0,0,0,0,0,0,0,0,0,0
Wildcats,0,0,0,0,0,0,0,0,0,0,0,0,0,0,0,0,0,0,0,0,0,0,0,0
Lynx,0,1,0,0,0,1,0,0,0,0,0,0,0,0,0,0,0,0,0,0,0,0,0,0
Mariners,0,1,0,0,0,1,0,0,0,0,0,0,0,0,0,0,0,0,0,0,0,0,0,0
Mountaineers,0,0,0,0,0,0,0,0,0,0,0,0,0,0,0,0,0,0,0,0,0,0,0,0
Eagles,0,0,0,0,0,0,0,0,0,0,0,0,0,0,0,0,0,0,0,0,0,0,0,0
Cardinals,0,1,0,0,0,1,0,0,0,0,0,0,0,0,0,0,0,0,0,0,0,0,0,0
Red Dragons,0,2,0,0,0,2,0,0,0,0,0,0,0,0,0,0,0,0,0,0,0,0,0,0
Griffins,0,0,0,0,0,0,0,0,0,0,0,0,0,0,0,0,0,0,0,0,0,0,0,0
Panthers,0,0,0,0,0,0,0,0,0,0,0,0,0,0,0,0,0,0,0,0,0,0,0,0
Blue Jays,0,2,0,0,0,2,0,0,0,0,0,0,0,0,0,0,0,0,0,0,0,0,0,0
Golden Eagles,0,0,0,0,0,0,0,0,0,0,0,0,0,0,0,0,0,0,0,0,0,0,0,0
Poets,0,1,0,0,0,1,0,0,0,0,0,0,0,0,0,0,0,0,0,0,0,0,0,0
Beavers,0,0,0,0,0,0,0,0,0,0,0,0,0,0,0,0,0,0,0,0,0,0,0,0
Leopards,0,2,0,0,0,2,0,0,0,0,0,0,0,0,0,0,0,0,0,0,0,0,0,0
Panthers,0,1,0,0,0,1,0,0,0,0,0,0,0,0,0,0,0,0,0,0,0,0,0,0
Kingsmen,0,0,0,0,0,0,0,0,0,0,0,0,0,0,0,0,0,0,0,0,0,0,0,0
Sagehens,0,0,0,0,0,0,0,0,0,0,0,0,0,0,0,0,0,0,0,0,0,0,0,0
Cougars,0,1,0,0,0,1,0,0,0,0,0,0,0,0,0,0,0,0,0,0,0,0,0,0
Saints,0,0,0,0,0,0,0,0,0,0,0,0,0,0,0,0,0,0,0,0,0,0,0,0
Tomcats,0,0,0,0,0,0,0,0,0,0,0,0,0,0,0,0,0,0,0,0,0,0,0,0
Titans,0,0,0,0,0,0,0,0,0,0,0,0,0,0,0,0,0,0,0,0,0,0,0,0
Golden Torandoes,0,0,0,0,0,0,0,0,0,0,0,0,0,0,0,0,0,0,0,0,0,0,0,0
Profs,0,0,0,0,0,0,0,0,0,0,0,0,0,0,0,0,0,0,0,0,0,0,0,0
Raiders,0,0,0,0,0,0,0,0,0,0,0,0,0,0,0,0,0,0,0,0,0,0,0,0
Cougars,0,1,0,0,0,1,0,0,0,0,0,0,0,0,0,0,0,0,0,0,0,0,0,0
Mighty Believers,0,0,0,0,0,0,0,0,0,0,0,0,0,0,0,0,0,0,0,0,0,0,0,0
Panthers,0,2,0,0,0,2,0,0,0,0,0,0,0,0,0,0,0,0,0,0,0,0,0,0
Monarchs,0,0,0,0,0,0,0,0,0,0,0,0,0,0,0,0,0,0,0,0,0,0,0,0
Piedmont,0,2,0,0,0,2,0,0,0,0,0,0,0,0,0,0,0,0,0,0,0,0,0,0
Pacers,0,2,0,0,0,2,0,0,0,0,0,0,0,0,0,0,0,0,0,0,0,0,0,0
NC Wesleyan,0,2,0,0,0,2,0,0,0,0,0,0,0,0,0,0,0,0,0,0,0,0,0,0
Panthers,0,1,0,0,0,1,0,0,0,0,0,0,0,0,0,0,0,0,0,0,0,0,0,0
Cougars,0,1,0,0,0,1,0,0,0,0,0,0,0,0,0,0,0,0,0,0,0,0,0,0
Pride,0,0,0,0,0,0,0,0,0,0,0,0,0,0,0,0,0,0,0,0,0,0,0,0
Soaring Eagles,0,0,0,0,0,0,0,0,0,0,0,0,0,0,0,0,0,0,0,0,0,0,0,0
Highlanders,0,2,0,0,0,2,0,0,0,0,0,0,0,0,0,0,0,0,0,0,0,0,0,0
Hawks,0,0,0,0,0,0,0,0,0,0,0,0,0,0,0,0,0,0,0,0,0,0,0,0
Golden Flyers,0,1,0,0,0,1,0,0,0,0,0,0,0,0,0,0,0,0,0,0,0,0,0,0
Pioneers,0,0,0,0,0,0,0,0,0,0,0,0,0,0,0,0,0,0,0,0,0,0,0,0
Falcons,0,0,0,0,0,0,0,0,0,0,0,0,0,0,0,0,0,0,0,0,0,0,0,0
Wildcats,0,2,0,0,0,2,0,0,0,0,0,0,0,0,0,0,0,0,0,0,0,0,0,0
Rams,0,0,0,0,0,0,0,0,0,0,0,0,0,0,0,0,0,0,0,0,0,0,0,0
Mustangs,0,0,0,0,0,0,0,0,0,0,0,0,0,0,0,0,0,0,0,0,0,0,0,0
Gators,0,0,0,0,0,0,0,0,0,0,0,0,0,0,0,0,0,0,0,0,0,0,0,0
Tigers,0,2,0,0,0,2,0,0,0,0,0,0,0,0,0,0,0,0,0,0,0,0,0,0
Gentlemen,0,0,0,0,0,0,0,0,0,0,0,0,0,0,0,0,0,0,0,0,0,0,0,0
Pirates,0,1,0,0,0,1,0,0,0,0,0,0,0,0,0,0,0,0,0,0,0,0,0,0
Bulldogs,0,2,0,0,0,2,0,0,0,0,0,0,0,0,0,0,0,0,0,0,0,0,0,0
Tigers,0,1,0,0,0,1,0,0,0,0,0,0,0,0,0,0,0,0,0,0,0,0,0,0
Mountaineers,0,2,0,0,0,2,0,0,0,0,0,0,0,0,0,0,0,0,0,0,0,0,0,0
Kangaroos,0,0,0,0,0,0,0,0,0,0,0,0,0,0,0,0,0,0,0,0,0,0,0,0
Storm,0,0,0,0,0,0,0,0,0,0,0,0,0,0,0,0,0,0,0,0,0,0,0,0
Kohawks,0,0,0,0,0,0,0,0,0,0,0,0,0,0,0,0,0,0,0,0,0,0,0,0
Spartans,0,1,0,0,0,1,0,0,0,0,0,0,0,0,0,0,0,0,0,0,0,0,0,0
Knights,0,0,0,0,0,0,0,0,0,0,0,0,0,0,0,0,0,0,0,0,0,0,0,0
Rams,0,0,0,0,0,0,0,0,0,0,0,0,0,0,0,0,0,0,0,0,0,0,0,0
Beavers,0,0,0,0,0,0,0,0,0,0,0,0,0,0,0,0,0,0,0,0,0,0,0,0
Lyons,0,0,0,0,0,0,0,0,0,0,0,0,0,0,0,0,0,0,0,0,0,0,0,0
Bears,0,0,0,0,0,0,0,0,0,0,0,0,0,0,0,0,0,0,0,0,0,0,0,0
Lions,0,2,0,0,0,2,0,0,0,0,0,0,0,0,0,0,0,0,0,0,0,0,0,0
Engineers,0,0,0,0,0,0,0,0,0,0,0,0,0,0,0,0,0,0,0,0,0,0,0,0
Bearcats,0,1,0,0,0,1,0,0,0,0,0,0,0,0,0,0,0,0,0,0,0,0,0,0
Banana Slugs,0,0,0,0,0,0,0,0,0,0,0,0,0,0,0,0,0,0,0,0,0,0,0,0
Mountaineers,0,0,0,0,0,0,0,0,0,0,0,0,0,0,0,0,0,0,0,0,0,0,0,0
Vikings,0,0,0,0,0,0,0,0,0,0,0,0,0,0,0,0,0,0,0,0,0,0,0,0
Bluejays,0,0,0,0,0,0,0,0,0,0,0,0,0,0,0,0,0,0,0,0,0,0,0,0
Dutchmen,0,0,0,0,0,0,0,0,0,0,0,0,0,0,0,0,0,0,0,0,0,0,0,0
Loggers,0,0,0,0,0,0,0,0,0,0,0,0,0,0,0,0,0,0,0,0,0,0,0,0
Pioneers,0,1,0,0,0,1,0,0,0,0,0,0,0,0,0,0,0,0,0,0,0,0,0,0
Bruins,0,0,0,0,0,0,0,0,0,0,0,0,0,0,0,0,0,0,0,0,0,0,0,0
Bearcats,0,1,0,0,0,1,0,0,0,0,0,0,0,0,0,0,0,0,0,0,0,0,0,0
Pirates,0,0,0,0,0,0,0,0,0,0,0,0,0,0,0,0,0,0,0,0,0,0,0,0
Lutes,0,0,0,0,0,0,0,0,0,0,0,0,0,0,0,0,0,0,0,0,0,0,0,0
Wildcats,0,0,0,0,0,0,0,0,0,0,0,0,0,0,0,0,0,0,0,0,0,0,0,0
Boxers,0,1,0,0,0,1,0,0,0,0,0,0,0,0,0,0,0,0,0,0,0,0,0,0
Generals,0,0,0,0,0,0,0,0,0,0,0,0,0,0,0,0,0,0,0,0,0,0,0,0
Maroons,0,0,0,0,0,0,0,0,0,0,0,0,0,0,0,0,0,0,0,0,0,0,0,0
Quakers,0,0,0,0,0,0,0,0,0,0,0,0,0,0,0,0,0,0,0,0,0,0,0,0
Hornets,0,1,0,0,0,1,0,0,0,0,0,0,0,0,0,0,0,0,0,0,0,0,0,0
Wildcats,0,1,0,0,0,1,0,0,0,0,0,0,0,0,0,0,0,0,0,0,0,0,0,0
Eagles,0,0,0,0,0,0,0,0,0,0,0,0,0,0,0,0,0,0,0,0,0,0,0,0
Tigers,0,0,0,0,0,0,0,0,0,0,0,0,0,0,0,0,0,0,0,0,0,0,0,0
Royals,0,0,0,0,0,0,0,0,0,0,0,0,0,0,0,0,0,0,0,0,0,0,0,0
Wasps,0,0,0,0,0,0,0,0,0,0,0,0,0,0,0,0,0,0,0,0,0,0,0,0
Hornets,0,0,0,0,0,0,0,0,0,0,0,0,0,0,0,0,0,0,0,0,0,0,0,0
Pioneers,0,0,0,0,0,0,0,0,0,0,0,0,0,0,0,0,0,0,0,0,0,0,0,0
Barons,0,1,0,0,0,1,0,0,0,0,0,0,0,0,0,0,0,0,0,0,0,0,0,0
Mavericks,0,0,0,0,0,0,0,0,0,0,0,0,0,0,0,0,0,0,0,0,0,0,0,0
Panthers,0,1,0,0,0,1,0,0,0,0,0,0,0,0,0,0,0,0,0,0,0,0,0,0
Red Hawks,0,0,0,0,0,0,0,0,0,0,0,0,0,0,0,0,0,0,0,0,0,0,0,0
Lions,0,1,0,0,0,1,0,0,0,0,0,0,0,0,0,0,0,0,0,0,0,0,0,0
Bison,0,1,0,0,0,1,0,0,0,0,0,0,0,0,0,0,0,0,0,0,0,0,0,0
Mustangs,0,0,0,0,0,0,0,0,0,0,0,0,0,0,0,0,0,0,0,0,0,0,0,0
Wolfpack,0,0,0,0,0,0,0,0,0,0,0,0,0,0,0,0,0,0,0,0,0,0,0,0
Hornets,0,1,0,0,0,1,0,0,0,0,0,0,0,0,0,0,0,0,0,0,0,0,0,0
Terriers,0,1,0,0,0,1,0,0,0,0,0,0,0,0,0,0,0,0,0,0,0,0,0,0
Regents,0,1,0,0,0,1,0,0,0,0,0,0,0,0,0,0,0,0,0,0,0,0,0,0
Spartans,0,1,0,0,0,0,0,0,0,0,0,0,0,0,0,0,0,0,0,0,0,0,0,0
Raiders,0,0,0,0,0,0,0,0,0,0,0,0,0,0,0,0,0,0,0,0,0,0,0,0
Muskies,0,1,0,0,0,1,0,0,0,0,0,0,0,0,0,0,0,0,0,0,0,0,0,0
Beacons,0,2,0,0,0,2,0,0,0,0,0,0,0,0,0,0,0,0,0,0,0,0,0,0
Seahawks,0,0,0,0,0,0,0,0,0,0,0,0,0,0,0,0,0,0,0,0,0,0,0,0
Spartans,0,0,0,0,0,0,0,0,0,0,0,0,0,0,0,0,0,0,0,0,0,0,0,0
Wolverines,0,0,0,0,0,0,0,0,0,0,0,0,0,0,0,0,0,0,0,0,0,0,0,0
Bobcats,0,1,0,0,0,1,0,0,0,0,0,0,0,0,0,0,0,0,0,0,0,0,0,0
Eagles,0,0,0,0,0,0,0,0,0,0,0,0,0,0,0,0,0,0,0,0,0,0,0,0
Nittany Lions,0,0,0,0,0,0,0,0,0,0,0,0,0,0,0,0,0,0,0,0,0,0,0,0
Sea Gulls,0,0,0,0,0,0,0,0,0,0,0,0,0,0,0,0,0,0,0,0,0,0,0,0
Randall,0,2,0,0,0,2,0,0,0,0,0,0,0,0,0,0,0,0,0,0,0,0,0,0
Carver College,0,0,0,0,0,0,0,0,0,0,0,0,0,0,0,0,0,0,0,0,0,0,0,0
Our Lady of the Lake University,0,2,0,0,0,2,0,0,0,0,0,0,0,0,0,0,0,0,0,0,0,0,0,0
Mary Hardin-Baylor,0,0,0,0,0,0,0,0,0,0,0,0,0,0,0,0,0,0,0,0,0,0,0,0
University of New England Nor'easters,0,0,0,0,0,0,0,0,0,0,0,0,0,0,0,0,0,0,0,0,0,0,0,0
Webster Gorloks,0,0,0,0,0,0,0,0,0,0,0,0,0,0,0,0,0,0,0,0,0,0,0,0
Philander Smith Panthers,0,0,0,0,0,0,0,0,0,0,0,0,0,0,0,0,0,0,0,0,0,0,0,0
St. John Fisher Cardinals,0,0,0,0,0,0,0,0,0,0,0,0,0,0,0,0,0,0,0,0,0,0,0,0
Penn State-Erie Behrend Lions,0,0,0,0,0,0,0,0,0,0,0,0,0,0,0,0,0,0,0,0,0,0,0,0
SUNY-Fredonia Blue Devils,0,1,0,0,0,1,0,0,0,0,0,0,0,0,0,0,0,0,0,0,0,0,0,0
Ohio Wesleyan Battling Bishops,0,1,0,0,0,1,0,0,0,0,0,0,0,0,0,0,0,0,0,0,0,0,0,0
Penn State Greater Allegheny Lions,0,0,0,0,0,0,0,0,0,0,0,0,0,0,0,0,0,0,0,0,0,0,0,0
Converse Valkyries,0,0,0,0,0,0,0,0,0,0,0,0,0,0,0,0,0,0,0,0,0,0,0,0
Clinton College Golden Bears,0,0,0,0,0,0,0,0,0,0,0,0,0,0,0,0,0,0,0,0,0,0,0,0
Centre Colonels,0,0,0,0,0,0,0,0,0,0,0,0,0,0,0,0,0,0,0,0,0,0,0,0
Buffalo State Bengals,0,0,0,0,0,0,0,0,0,0,0,0,0,0,0,0,0,0,0,0,0,0,0,0
Babson Beavers,0,0,0,0,0,0,0,0,0,0,0,0,0,0,0,0,0,0,0,0,0,0,0,0
Carroll College Flying Saints,0,0,0,0,0,0,0,0,0,0,0,0,0,0,0,0,0,0,0,0,0,0,0,0
Arkansas Baptist Buffaloes,0,3,0,0,0,3,0,0,0,0,0,0,0,0,0,0,0,0,0,0,0,0,0,0
Life University Running Eagles,0,0,0,0,0,0,0,0,0,0,0,0,0,0,0,0,0,0,0,0,0,0,0,0
DePauw Tigers,0,0,0,0,0,0,0,0,0,0,0,0,0,0,0,0,0,0,0,0,0,0,0,0
Knox Prarie Fire,0,0,0,0,0,0,0,0,0,0,0,0,0,0,0,0,0,0,0,0,0,0,0,0
Hanover Panthers,0,0,0,0,0,0,0,0,0,0,0,0,0,0,0,0,0,0,0,0,0,0,0,0
Miami-Hamilton Harriers,0,1,0,0,0,1,0,0,0,0,0,0,0,0,0,0,0,0,0,0,0,0,0,0
Maine-Farmington Beavers,0,0,0,0,0,0,0,0,0,0,0,0,0,0,0,0,0,0,0,0,0,0,0,0
Mary Baldwin Fighting Squirrels,0,2,0,0,0,2,0,0,0,0,0,0,0,0,0,0,0,0,0,0,0,0,0,0
Point University Skyhawks,0,1,0,0,0,1,0,0,0,0,0,0,0,0,0,0,0,0,0,0,0,0,0,0
Embry-Riddle (AZ) Eagles,0,2,0,0,0,2,0,0,0,0,0,0,0,0,0,0,0,0,0,0,0,0,0,0
Allen Fighting Yellow Jackets,0,0,0,0,0,0,0,0,0,0,0,0,0,0,0,0,0,0,0,0,0,0,0,0
Campbellsville Tigers,0,1,0,0,0,1,0,0,0,0,0,0,0,0,0,0,0,0,0,0,0,0,0,0
Siena Heights,0,1,0,0,0,1,0,0,0,0,0,0,0,0,0,0,0,0,0,0,0,0,0,0
Rio Grande Red Storm,0,0,0,0,0,0,0,0,0,0,0,0,0,0,0,0,0,0,0,0,0,0,0,0
University of the Southwest Mustangs,0,1,0,0,0,1,0,0,0,0,0,0,0,0,0,0,0,0,0,0,0,0,0,0
University of the Virgin Islands Buccaneers,0,0,0,0,0,0,0,0,0,0,0,0,0,0,0,0,0,0,0,0,0,0,0,0
Augustana College Vikings,0,0,0,0,0,0,0,0,0,0,0,0,0,0,0,0,0,0,0,0,0,0,0,0
Bethany (WV) Bison,0,2,0,0,0,2,0,0,0,0,0,0,0,0,0,0,0,0,0,0,0,0,0,0
Dakota State,0,0,0,0,0,0,0,0,0,0,0,0,0,0,0,0,0,0,0,0,0,0,0,0
Corban College,0,1,0,0,0,1,0,0,0,0,0,0,0,0,0,0,0,0,0,0,0,0,0,0
St Xavier,0,0,0,0,0,0,0,0,0,0,0,0,0,0,0,0,0,0,0,0,0,0,0,0
Dominican (IL),0,0,0,0,0,0,0,0,0,0,0,0,0,0,0,0,0,0,0,0,0,0,0,0
Warner Pacific,0,0,0,0,0,0,0,0,0,0,0,0,0,0,0,0,0,0,0,0,0,0,0,0
Lincoln (CA),0,3,0,0,0,3,0,0,0,0,0,0,0,0,0,0,0,0,0,0,0,0,0,0
Clarkson,0,0,0,0,0,0,0,0,0,0,0,0,0,0,0,0,0,0,0,0,0,0,0,0
Missouri Valley,0,0,0,0,0,0,0,0,0,0,0,0,0,0,0,0,0,0,0,0,0,0,0,0
Peru State,0,0,0,0,0,0,0,0,0,0,0,0,0,0,0,0,0,0,0,0,0,0,0,0
Texas Wesleyan,0,2,0,0,0,2,0,0,0,0,0,0,0,0,0,0,0,0,0,0,0,0,0,0
AZ Christian,0,0,0,0,0,0,0,0,0,0,0,0,0,0,0,0,0,0,0,0,0,0,0,0
TCNJ,0,0,0,0,0,0,0,0,0,0,0,0,0,0,0,0,0,0,0,0,0,0,0,0
Hiwassee College,0,0,0,0,0,0,0,0,0,0,0,0,0,0,0,0,0,0,0,0,0,0,0,0
Johnson (TN),0,2,0,0,0,2,0,0,0,0,0,0,0,0,0,0,0,0,0,0,0,0,0,0
LSU Alexandria,0,1,0,0,0,1,0,0,0,0,0,0,0,0,0,0,0,0,0,0,0,0,0,0
Wisconsin Lutheran,0,0,0,0,0,0,0,0,0,0,0,0,0,0,0,0,0,0,0,0,0,0,0,0
Wilberforce,0,0,0,0,0,0,0,0,0,0,0,0,0,0,0,0,0,0,0,0,0,0,0,0
La Sierra University,0,5,0,0,0,5,0,0,0,0,0,0,0,0,0,0,0,0,0,0,0,0,0,0
William Carey,0,2,0,0,0,2,0,0,0,0,0,0,0,0,0,0,0,0,0,0,0,0,0,0
Huston-Tillotson,0,0,0,0,0,0,0,0,0,0,0,0,0,0,0,0,0,0,0,0,0,0,0,0
Harris-Stowe State,0,1,0,0,0,1,0,0,0,0,0,0,0,0,0,0,0,0,0,0,0,0,0,0
Wayland Baptist,0,1,0,0,0,1,0,0,0,0,0,0,0,0,0,0,0,0,0,0,0,0,0,0
Reinhardt,0,0,0,0,0,0,0,0,0,0,0,0,0,0,0,0,0,0,0,0,0,0,0,0
Eastern Oregon,0,1,0,0,0,1,0,0,0,0,0,0,0,0,0,0,0,0,0,0,0,0,0,0
Warner Southern,0,2,0,0,0,2,0,0,0,0,0,0,0,0,0,0,0,0,0,0,0,0,0,0
Lyon,0,0,0,0,0,0,0,0,0,0,0,0,0,0,0,0,0,0,0,0,0,0,0,0
Mayville State,0,0,0,0,0,0,0,0,0,0,0,0,0,0,0,0,0,0,0,0,0,0,0,0
West Virginia Tech,0,0,0,0,0,0,0,0,0,0,0,0,0,0,0,0,0,0,0,0,0,0,0,0
Wolves,0,1,0,0,0,1,0,1,0,0,0,0,0,1,0,1,0,0,0,0,0,1,0,0
Comets,0,1,0,0,0,1,0,1,0,0,0,0,0,1,0,0,1,0,0,0,0,0,1,0
Red Devils,0,3,0,0,0,3,0,1,0,0,0,0,0,1,0,1,0,0,0,0,0,1,0,0
Webber International,0,1,0,0,0,1,0,1,0,0,0,0,0,1,0,1,0,0,0,0,0,1,0,0
Auburn Montgomery,0,1,0,0,0,1,0,1,0,0,0,0,0,1,0,0,1,0,0,0,0,0,1,0
Edward Waters,0,1,0,0,0,1,0,1,0,0,0,0,0,1,0,1,0,0,0,0,0,1,0,0
Mustangs,0,2,0,0,0,2,0,2,0,0,0,0,0,2,0,2,0,0,0,0,0,2,0,0
Cougars,0,2,0,0,0,2,0,2,0,0,0,0,0,2,0,0,2,0,0,0,0,0,2,0
